Year,Election Type,County,Precinct,Active Voters,Inactive Voters,Total Voters,Ballots Cast,Total Voters Turnout %,Comments
2012,G,ADAMS,4253001245,291,69,360,353,98.06,
2012,G,ADAMS,4255601241,39,19,58,35,60.34,
2012,G,ADAMS,4255601246,946,374,1320,889,67.35,
2012,G,ADAMS,4255601247,389,70,459,372,81.05,
2012,G,ADAMS,4255601248,1748,464,2212,1670,75.5,
2012,G,ADAMS,4255601249,18,6,24,18,75,
2012,G,ADAMS,4255601250,274,62,336,252,75,
2012,G,ADAMS,4255601251,12,2,14,13,92.86,
2012,G,ADAMS,6243101150,1255,374,1629,1226,75.26,
2012,G,ADAMS,6243101151,1139,344,1483,1113,75.05,
2012,G,ADAMS,6243101159,875,180,1055,853,80.85,
2012,G,ADAMS,6243401075,825,124,949,793,83.56,
2012,G,ADAMS,6243401076,1019,312,1331,1027,77.16,
2012,G,ADAMS,6243401077,603,185,788,586,74.37,
2012,G,ADAMS,6245601071,517,149,666,503,75.53,
2012,G,ADAMS,6245601072,143,39,182,142,78.02,
2012,G,ADAMS,6245601073,799,175,974,779,79.98,
2012,G,ADAMS,6245601074,903,203,1106,892,80.65,
2012,G,ADAMS,6245601160,309,64,373,300,80.43,
2012,G,ADAMS,6253001152,913,235,1148,876,76.31,
2012,G,ADAMS,6253001153,551,91,642,513,79.91,
2012,G,ADAMS,6253001154,50,11,61,46,75.41,
2012,G,ADAMS,6253001155,267,35,302,250,82.78,
2012,G,ADAMS,6253001156,221,37,258,219,84.88,
2012,G,ADAMS,6253001157,769,162,931,734,78.84,
2012,G,ADAMS,6253001226,179,59,238,165,69.33,
2012,G,ADAMS,6253001229,1844,1291,3135,1387,44.24,
2012,G,ADAMS,6253001230,1637,707,2344,1377,58.75,
2012,G,ADAMS,6253001231,1190,715,1905,933,48.98,
2012,G,ADAMS,6253001232,289,129,418,242,57.89,
2012,G,ADAMS,6253001233,1082,345,1427,941,65.94,
2012,G,ADAMS,6253001234,891,381,1272,791,62.19,
2012,G,ADAMS,6253001235,642,431,1073,511,47.62,
2012,G,ADAMS,6253001236,941,411,1352,819,60.58,
2012,G,ADAMS,6253001237,922,440,1362,756,55.51,
2012,G,ADAMS,6253001238,930,382,1312,861,65.63,
2012,G,ADAMS,6253001239,847,336,1183,764,64.58,
2012,G,ADAMS,6253001240,821,335,1156,732,63.32,
2012,G,ADAMS,6253001242,375,103,478,391,81.8,
2012,G,ADAMS,6253001243,634,114,748,612,81.82,
2012,G,ADAMS,6253101158,693,254,947,688,72.65,
2012,G,ADAMS,6255601161,119,26,145,114,78.62,
2012,G,ADAMS,6255601162,696,115,811,683,84.22,
2012,G,ADAMS,6255601163,144,28,172,133,77.33,
2012,G,ADAMS,6255601164,369,69,438,358,81.74,
2012,G,ADAMS,6255601165,510,23,533,494,92.68,
2012,G,ADAMS,6255601166,382,73,455,371,81.54,
2012,G,ADAMS,6255601167,421,84,505,411,81.39,
2012,G,ADAMS,6255601168,127,24,151,123,81.46,
2012,G,ADAMS,6255601169,406,86,492,394,80.08,
2012,G,ADAMS,6255601170,1021,434,1455,942,64.74,
2012,G,ADAMS,6255601171,1026,261,1287,963,74.83,
2012,G,ADAMS,6255601172,197,94,291,181,62.2,
2012,G,ADAMS,6255601173,89,20,109,84,77.06,
2012,G,ADAMS,6255601174,145,27,172,142,82.56,
2012,G,ADAMS,6255601175,990,259,1249,922,73.82,
2012,G,ADAMS,6255601176,332,62,394,318,80.71,
2012,G,ADAMS,6255601177,0,0,0,0,0,
2012,G,ADAMS,6255601178,1,1,2,0,0,
2012,G,ADAMS,6255601179,0,0,0,0,0,
2012,G,ADAMS,6255601180,490,111,601,472,78.54,
2012,G,ADAMS,6255601181,1056,410,1466,1028,70.12,
2012,G,ADAMS,6255601182,452,144,596,436,73.15,
2012,G,ADAMS,6255601183,183,40,223,179,80.27,
2012,G,ADAMS,6255601184,234,53,287,227,79.09,
2012,G,ADAMS,6255601185,421,92,513,415,80.9,
2012,G,ADAMS,6255601186,935,352,1287,889,69.08,
2012,G,ADAMS,6255601187,949,309,1258,869,69.08,
2012,G,ADAMS,6255601188,645,130,775,610,78.71,
2012,G,ADAMS,6255601189,715,103,818,680,83.13,
2012,G,ADAMS,6255601190,1001,255,1256,947,75.4,
2012,G,ADAMS,6255601191,1112,435,1547,1046,67.61,
2012,G,ADAMS,6255601192,675,292,967,623,64.43,
2012,G,ADAMS,6255601193,890,462,1352,827,61.17,
2012,G,ADAMS,6255601194,208,25,233,202,86.7,
2012,G,ADAMS,6255601195,315,64,379,298,78.63,
2012,G,ADAMS,6255601196,82,67,149,75,50.34,
2012,G,ADAMS,6255601197,37,13,50,35,70,
2012,G,ADAMS,6255601198,552,99,651,523,80.34,
2012,G,ADAMS,6255601227,307,46,353,294,83.29,
2012,G,ADAMS,6255601228,742,167,909,733,80.64,
2012,G,ADAMS,6255601244,567,85,652,542,83.13,
2012,G,ADAMS,7213001130,243,78,321,225,70.09,
2012,G,ADAMS,7213001140,473,171,644,454,70.5,
2012,G,ADAMS,7213001141,665,275,940,657,69.89,
2012,G,ADAMS,7213001199,498,104,602,478,79.4,
2012,G,ADAMS,7213001200,109,13,122,108,88.52,
2012,G,ADAMS,7213001201,226,55,281,220,78.29,
2012,G,ADAMS,7213001202,307,62,369,294,79.67,
2012,G,ADAMS,7213001203,173,35,208,169,81.25,
2012,G,ADAMS,7213001204,543,211,754,523,69.36,
2012,G,ADAMS,7213001205,914,268,1182,886,74.96,
2012,G,ADAMS,7213001206,1001,332,1333,971,72.84,
2012,G,ADAMS,7213001207,554,100,654,529,80.89,
2012,G,ADAMS,7213001210,753,202,955,728,76.23,
2012,G,ADAMS,7213001211,337,128,465,295,63.44,
2012,G,ADAMS,7213001212,115,27,142,114,80.28,
2012,G,ADAMS,7213001213,53,7,60,54,90,
2012,G,ADAMS,7213001214,819,240,1059,793,74.88,
2012,G,ADAMS,7213001215,1044,293,1337,998,74.64,
2012,G,ADAMS,7213001225,194,31,225,187,83.11,
2012,G,ADAMS,7213101117,1245,453,1698,1160,68.32,
2012,G,ADAMS,7213101118,805,325,1130,756,66.9,
2012,G,ADAMS,7213201001,1187,585,1772,1048,59.14,
2012,G,ADAMS,7213201002,1176,418,1594,1057,66.31,
2012,G,ADAMS,7213201003,405,139,544,384,70.59,
2012,G,ADAMS,7213201004,691,281,972,647,66.56,
2012,G,ADAMS,7213201005,1202,446,1648,1140,69.17,
2012,G,ADAMS,7213201006,743,440,1183,664,56.13,
2012,G,ADAMS,7213201007,1046,346,1392,950,68.25,
2012,G,ADAMS,7213201008,793,274,1067,754,70.67,
2012,G,ADAMS,7213201009,710,225,935,670,71.66,
2012,G,ADAMS,7213201021,1101,523,1624,1023,62.99,
2012,G,ADAMS,7213201022,1139,398,1537,1062,69.1,
2012,G,ADAMS,7213201023,817,356,1173,749,63.85,
2012,G,ADAMS,7213201119,972,438,1410,888,62.98,
2012,G,ADAMS,7213201120,922,437,1359,872,64.16,
2012,G,ADAMS,7213201121,929,432,1361,869,63.85,
2012,G,ADAMS,7213201122,561,245,806,523,64.89,
2012,G,ADAMS,7213201123,1145,531,1676,974,58.11,
2012,G,ADAMS,7213201124,1097,493,1590,981,61.7,
2012,G,ADAMS,7213201125,1390,613,2003,1200,59.91,
2012,G,ADAMS,7213201126,1215,517,1732,1104,63.74,
2012,G,ADAMS,7213201127,1298,559,1857,1189,64.03,
2012,G,ADAMS,7213201128,1562,755,2317,1388,59.91,
2012,G,ADAMS,7213201129,678,409,1087,635,58.42,
2012,G,ADAMS,7213201208,377,188,565,359,63.54,
2012,G,ADAMS,7213201209,549,167,716,517,72.21,
2012,G,ADAMS,7213201216,1285,361,1646,1206,73.27,
2012,G,ADAMS,7213201217,481,144,625,456,72.96,
2012,G,ADAMS,7213201218,414,84,498,399,80.12,
2012,G,ADAMS,7213201219,154,47,201,147,73.13,
2012,G,ADAMS,7213201220,0,0,0,0,0,
2012,G,ADAMS,7213201221,363,58,421,354,84.09,
2012,G,ADAMS,7213201222,0,0,0,0,0,
2012,G,ADAMS,7213201223,0,0,0,0,0,
2012,G,ADAMS,7213201224,35,12,47,33,70.21,
2012,G,ADAMS,7213401027,614,353,967,544,56.26,
2012,G,ADAMS,7213401030,819,440,1259,739,58.7,
2012,G,ADAMS,7213401035,813,518,1331,753,56.57,
2012,G,ADAMS,7213401036,645,165,810,618,76.3,
2012,G,ADAMS,7213401042,818,501,1319,762,57.77,
2012,G,ADAMS,7213501010,1107,553,1660,993,59.82,
2012,G,ADAMS,7213501011,1213,485,1698,1121,66.02,
2012,G,ADAMS,7213501012,998,320,1318,943,71.55,
2012,G,ADAMS,7213501013,1333,532,1865,1230,65.95,
2012,G,ADAMS,7213501014,945,312,1257,883,70.25,
2012,G,ADAMS,7213501015,1068,690,1758,914,51.99,
2012,G,ADAMS,7213501016,938,295,1233,883,71.61,
2012,G,ADAMS,7213501017,813,286,1099,764,69.52,
2012,G,ADAMS,7213501018,871,348,1219,811,66.53,
2012,G,ADAMS,7213501019,620,238,858,589,68.65,
2012,G,ADAMS,7213501020,920,418,1338,838,62.63,
2012,G,ADAMS,7213501024,1011,360,1371,961,70.09,
2012,G,ADAMS,7213501025,977,347,1324,900,67.98,
2012,G,ADAMS,7213501026,1357,611,1968,1227,62.35,
2012,G,ADAMS,7243101078,510,109,619,491,79.32,
2012,G,ADAMS,7243101079,728,151,879,705,80.2,
2012,G,ADAMS,7243101085,1034,245,1279,997,77.95,
2012,G,ADAMS,7243101086,930,224,1154,907,78.6,
2012,G,ADAMS,7243101088,985,240,1225,965,78.78,
2012,G,ADAMS,7243101089,1119,538,1657,1053,63.55,
2012,G,ADAMS,7243101093,1156,473,1629,1117,68.57,
2012,G,ADAMS,7243101094,1057,363,1420,1027,72.32,
2012,G,ADAMS,7243101097,869,291,1160,863,74.4,
2012,G,ADAMS,7243101105,178,114,292,148,50.68,
2012,G,ADAMS,7243101134,1181,468,1649,1143,69.31,
2012,G,ADAMS,7243101135,1173,452,1625,1148,70.65,
2012,G,ADAMS,7243101136,853,285,1138,838,73.64,
2012,G,ADAMS,7243101137,1209,347,1556,1172,75.32,
2012,G,ADAMS,7243101145,1000,325,1325,979,73.89,
2012,G,ADAMS,7243101146,926,469,1395,908,65.09,
2012,G,ADAMS,7243101147,1331,523,1854,1284,69.26,
2012,G,ADAMS,7243101149,1032,267,1299,990,76.21,
2012,G,ADAMS,7243401037,693,450,1143,615,53.81,
2012,G,ADAMS,7243401038,1124,475,1599,1047,65.48,
2012,G,ADAMS,7243401039,875,217,1092,830,76.01,
2012,G,ADAMS,7243401040,896,294,1190,843,70.84,
2012,G,ADAMS,7243401041,886,308,1194,839,70.27,
2012,G,ADAMS,7243401051,1205,414,1619,1178,72.76,
2012,G,ADAMS,7243401052,1383,740,2123,1272,59.92,
2012,G,ADAMS,7243401053,1040,240,1280,997,77.89,
2012,G,ADAMS,7243401080,892,208,1100,881,80.09,
2012,G,ADAMS,7243401081,837,219,1056,813,76.99,
2012,G,ADAMS,7243401082,837,204,1041,828,79.54,
2012,G,ADAMS,7243401083,1021,423,1444,990,68.56,
2012,G,ADAMS,7243401084,574,160,734,557,75.89,
2012,G,ADAMS,7243401087,945,769,1714,850,49.59,
2012,G,ADAMS,7243401090,917,728,1645,842,51.19,
2012,G,ADAMS,7243401091,911,561,1472,878,59.65,
2012,G,ADAMS,7243401092,1106,402,1508,1101,73.01,
2012,G,ADAMS,7243401095,1079,357,1436,1043,72.63,
2012,G,ADAMS,7243401096,879,275,1154,866,75.04,
2012,G,ADAMS,7243401098,866,298,1164,850,73.02,
2012,G,ADAMS,7243401099,635,231,866,616,71.13,
2012,G,ADAMS,7243401100,1122,487,1609,1083,67.31,
2012,G,ADAMS,7243401101,967,403,1370,932,68.03,
2012,G,ADAMS,7243401102,948,319,1267,929,73.32,
2012,G,ADAMS,7243401103,581,393,974,525,53.9,
2012,G,ADAMS,7243401104,884,340,1224,849,69.36,
2012,G,ADAMS,7243501031,1082,384,1466,999,68.14,
2012,G,ADAMS,7243501032,888,306,1194,836,70.02,
2012,G,ADAMS,7243501033,1244,493,1737,1189,68.45,
2012,G,ADAMS,7243501034,953,353,1306,920,70.44,
2012,G,ADAMS,7243501043,903,151,1054,890,84.44,
2012,G,ADAMS,7243501044,898,406,1304,876,67.18,
2012,G,ADAMS,7243501045,662,156,818,653,79.83,
2012,G,ADAMS,7243501046,694,136,830,689,83.01,
2012,G,ADAMS,7243501047,1019,182,1201,1000,83.26,
2012,G,ADAMS,7243501048,790,120,910,772,84.84,
2012,G,ADAMS,7243501049,987,257,1244,946,76.05,
2012,G,ADAMS,7243501050,877,243,1120,860,76.79,
2012,G,ADAMS,7243501054,763,190,953,742,77.86,
2012,G,ADAMS,7243501055,735,208,943,687,72.85,
2012,G,ADAMS,7243501056,988,238,1226,962,78.47,
2012,G,ADAMS,7243501057,762,183,945,728,77.04,
2012,G,ADAMS,7243501058,885,295,1180,837,70.93,
2012,G,ADAMS,7243501059,969,219,1188,948,79.8,
2012,G,ADAMS,7243501060,957,387,1344,910,67.71,
2012,G,ADAMS,7243501061,1239,527,1766,1171,66.31,
2012,G,ADAMS,7243501062,845,199,1044,818,78.35,
2012,G,ADAMS,7243501063,651,132,783,636,81.23,
2012,G,ADAMS,7243501064,1191,740,1931,1108,57.38,
2012,G,ADAMS,7243501065,867,214,1081,855,79.09,
2012,G,ADAMS,7243501066,217,141,358,207,57.82,
2012,G,ADAMS,7243501067,510,185,695,489,70.36,
2012,G,ADAMS,7243501068,1080,328,1408,1031,73.22,
2012,G,ADAMS,7243501069,620,54,674,611,90.65,
2012,G,ADAMS,7243501070,846,141,987,812,82.27,
2012,G,ADAMS,7253001131,585,300,885,541,61.13,
2012,G,ADAMS,7253001132,847,381,1228,771,62.79,
2012,G,ADAMS,7253001138,647,219,866,611,70.55,
2012,G,ADAMS,7253001139,171,47,218,161,73.85,
2012,G,ADAMS,7253001142,520,68,588,496,84.35,
2012,G,ADAMS,7253001143,610,243,853,581,68.11,
2012,G,ADAMS,7253001144,1106,440,1546,1094,70.76,
2012,G,ADAMS,7253001148,712,179,891,692,77.67,
2012,G,ADAMS,7253101106,1275,615,1890,1194,63.17,
2012,G,ADAMS,7253101107,926,335,1261,898,71.21,
2012,G,ADAMS,7253101108,942,391,1333,887,66.54,
2012,G,ADAMS,7253101109,1001,360,1361,948,69.65,
2012,G,ADAMS,7253101110,720,264,984,692,70.33,
2012,G,ADAMS,7253101111,925,349,1274,871,68.37,
2012,G,ADAMS,7253101112,1625,1127,2752,1446,52.54,
2012,G,ADAMS,7253101113,968,367,1335,920,68.91,
2012,G,ADAMS,7253101114,805,382,1187,735,61.92,
2012,G,ADAMS,7253101115,850,360,1210,806,66.61,
2012,G,ADAMS,7253101116,531,312,843,477,56.58,
2012,G,ADAMS,7253101133,1049,376,1425,1019,71.51,
2012,G,ADAMS,7253401028,807,345,1152,718,62.33,
2012,G,ADAMS,7253401029,1228,614,1842,1095,59.45,
2012,G,ALAMOSA,3356202001,692,317,1009,669,66.3,
2012,G,ALAMOSA,3356202002,804,464,1268,746,58.83,
2012,G,ALAMOSA,3356202003,1220,463,1683,1181,70.17,
2012,G,ALAMOSA,3356202004,1322,411,1733,1255,72.42,
2012,G,ALAMOSA,3356202005,596,225,821,558,67.97,
2012,G,ALAMOSA,3356202006,722,351,1073,708,65.98,
2012,G,ALAMOSA,3356202007,1105,486,1591,1064,66.88,
2012,G,ALAMOSA,3356202008,691,144,835,656,78.56,
2012,G,ARAPAHOE,1260303101,981,314,1295,874,67.49,
2012,G,ARAPAHOE,1260303102,948,267,1215,806,66.34,
2012,G,ARAPAHOE,1260303103,547,214,761,508,66.75,
2012,G,ARAPAHOE,1260303104,487,176,663,417,62.9,
2012,G,ARAPAHOE,1260303105,952,292,1244,887,71.3,
2012,G,ARAPAHOE,1260303106,386,220,606,356,58.75,
2012,G,ARAPAHOE,1260303107,676,203,879,639,72.7,
2012,G,ARAPAHOE,1260303108,601,96,697,581,83.36,
2012,G,ARAPAHOE,1260303109,617,103,720,586,81.39,
2012,G,ARAPAHOE,1260303110,448,63,511,447,87.48,
2012,G,ARAPAHOE,1260303111,1147,394,1541,1044,67.75,
2012,G,ARAPAHOE,1260303112,736,159,895,695,77.65,
2012,G,ARAPAHOE,1260303113,402,37,439,384,87.47,
2012,G,ARAPAHOE,1260303114,814,397,1211,714,58.96,
2012,G,ARAPAHOE,1260303115,857,272,1129,763,67.58,
2012,G,ARAPAHOE,1260303116,1049,303,1352,949,70.19,
2012,G,ARAPAHOE,1260303117,618,286,904,520,57.52,
2012,G,ARAPAHOE,1260303118,683,210,893,629,70.44,
2012,G,ARAPAHOE,1260303119,660,167,827,623,75.33,
2012,G,ARAPAHOE,1260303120,477,107,584,448,76.71,
2012,G,ARAPAHOE,1260303121,483,107,590,450,76.27,
2012,G,ARAPAHOE,1260303122,566,183,749,545,72.76,
2012,G,ARAPAHOE,1260303123,807,188,995,756,75.98,
2012,G,ARAPAHOE,1260303124,935,224,1159,847,73.08,
2012,G,ARAPAHOE,1260303125,530,236,766,458,59.79,
2012,G,ARAPAHOE,1260303129,520,97,617,497,80.55,
2012,G,ARAPAHOE,1260303130,810,187,997,757,75.93,
2012,G,ARAPAHOE,1260303131,924,118,1042,888,85.22,
2012,G,ARAPAHOE,1260303132,966,132,1098,919,83.7,
2012,G,ARAPAHOE,1260303133,982,127,1109,950,85.66,
2012,G,ARAPAHOE,1260303134,510,45,555,484,87.21,
2012,G,ARAPAHOE,1260303135,377,36,413,359,86.92,
2012,G,ARAPAHOE,1260303136,802,71,873,778,89.12,
2012,G,ARAPAHOE,1260303140,415,84,499,408,81.76,
2012,G,ARAPAHOE,1263803141,427,30,457,413,90.37,
2012,G,ARAPAHOE,1310903137,818,90,908,766,84.36,
2012,G,ARAPAHOE,1310903138,397,51,448,380,84.82,
2012,G,ARAPAHOE,1310903139,636,97,733,604,82.4,
2012,G,ARAPAHOE,1310903230,0,0,0,0,0,
2012,G,ARAPAHOE,1310903402,0,0,0,0,0,
2012,G,ARAPAHOE,1310903475,28,5,33,25,75.76,
2012,G,ARAPAHOE,1310903501,763,405,1168,650,55.65,
2012,G,ARAPAHOE,1310903502,986,449,1435,790,55.05,
2012,G,ARAPAHOE,4283603348,0,0,0,0,0,
2012,G,ARAPAHOE,4283603350,1,0,1,0,0,
2012,G,ARAPAHOE,4293603358,39,43,82,28,34.15,
2012,G,ARAPAHOE,4295603357,0,0,0,0,0,
2012,G,ARAPAHOE,4295603359,0,0,0,0,0,
2012,G,ARAPAHOE,4295603362,1692,255,1947,1594,81.87,
2012,G,ARAPAHOE,4295603363,842,165,1007,796,79.05,
2012,G,ARAPAHOE,4295603364,979,320,1299,937,72.13,
2012,G,ARAPAHOE,4295603365,456,128,584,438,75,
2012,G,ARAPAHOE,6260303126,554,264,818,455,55.62,
2012,G,ARAPAHOE,6260303127,95,35,130,85,65.38,
2012,G,ARAPAHOE,6260303128,371,70,441,350,79.37,
2012,G,ARAPAHOE,6260303143,632,197,829,573,69.12,
2012,G,ARAPAHOE,6260303153,1046,249,1295,940,72.59,
2012,G,ARAPAHOE,6260303161,617,163,780,586,75.13,
2012,G,ARAPAHOE,6260303162,655,260,915,587,64.15,
2012,G,ARAPAHOE,6260303201,355,48,403,345,85.61,
2012,G,ARAPAHOE,6260303202,339,43,382,335,87.7,
2012,G,ARAPAHOE,6260303203,702,68,770,668,86.75,
2012,G,ARAPAHOE,6260303204,1485,148,1633,1415,86.65,
2012,G,ARAPAHOE,6260303229,985,97,1082,943,87.15,
2012,G,ARAPAHOE,6260303231,1674,640,2314,1538,66.46,
2012,G,ARAPAHOE,6260303232,1343,148,1491,1285,86.18,
2012,G,ARAPAHOE,6260303234,322,126,448,270,60.27,
2012,G,ARAPAHOE,6260303249,775,61,836,739,88.4,
2012,G,ARAPAHOE,6260303253,1341,232,1573,1301,82.71,
2012,G,ARAPAHOE,6260303254,380,44,424,364,85.85,
2012,G,ARAPAHOE,6260303256,0,0,0,0,0,
2012,G,ARAPAHOE,6263803142,803,144,947,776,81.94,
2012,G,ARAPAHOE,6263803144,767,61,828,727,87.8,
2012,G,ARAPAHOE,6263803145,589,163,752,562,74.73,
2012,G,ARAPAHOE,6263803146,744,76,820,718,87.56,
2012,G,ARAPAHOE,6263803147,822,115,937,792,84.53,
2012,G,ARAPAHOE,6263803148,500,46,546,489,89.56,
2012,G,ARAPAHOE,6263803149,1094,89,1183,1071,90.53,
2012,G,ARAPAHOE,6263803150,1064,181,1245,987,79.28,
2012,G,ARAPAHOE,6263803151,791,295,1086,718,66.11,
2012,G,ARAPAHOE,6263803152,796,137,933,766,82.1,
2012,G,ARAPAHOE,6263803154,875,231,1106,810,73.24,
2012,G,ARAPAHOE,6263803155,1152,115,1267,1110,87.61,
2012,G,ARAPAHOE,6263803156,427,51,478,412,86.19,
2012,G,ARAPAHOE,6263803157,614,55,669,599,89.54,
2012,G,ARAPAHOE,6263803158,768,139,907,723,79.71,
2012,G,ARAPAHOE,6263803159,703,173,876,655,74.77,
2012,G,ARAPAHOE,6263803160,781,188,969,714,73.68,
2012,G,ARAPAHOE,6263803163,717,131,848,663,78.18,
2012,G,ARAPAHOE,6263803165,898,143,1041,855,82.13,
2012,G,ARAPAHOE,6263803166,411,52,463,403,87.04,
2012,G,ARAPAHOE,6263803167,825,147,972,776,79.84,
2012,G,ARAPAHOE,6263803168,883,90,973,865,88.9,
2012,G,ARAPAHOE,6263803169,935,139,1074,910,84.73,
2012,G,ARAPAHOE,6263803170,942,251,1193,844,70.75,
2012,G,ARAPAHOE,6263803171,700,93,793,683,86.13,
2012,G,ARAPAHOE,6263803172,715,107,822,682,82.97,
2012,G,ARAPAHOE,6263803173,1219,227,1446,1175,81.26,
2012,G,ARAPAHOE,6263803174,906,132,1038,867,83.53,
2012,G,ARAPAHOE,6263803175,732,113,845,705,83.43,
2012,G,ARAPAHOE,6263803176,857,147,1004,813,80.98,
2012,G,ARAPAHOE,6264003255,975,270,1245,894,71.81,
2012,G,ARAPAHOE,6264003258,295,24,319,230,72.1,
2012,G,ARAPAHOE,6264003323,29,5,34,27,79.41,
2012,G,ARAPAHOE,6264003424,0,0,0,0,0,
2012,G,ARAPAHOE,6264003453,490,75,565,468,82.83,
2012,G,ARAPAHOE,6264003455,264,64,328,247,75.3,
2012,G,ARAPAHOE,6264103401,1113,355,1468,964,65.67,
2012,G,ARAPAHOE,6264103403,731,310,1041,628,60.33,
2012,G,ARAPAHOE,6264103404,307,134,441,225,51.02,
2012,G,ARAPAHOE,6264103405,836,288,1124,666,59.25,
2012,G,ARAPAHOE,6264103406,440,168,608,392,64.47,
2012,G,ARAPAHOE,6264103407,1604,530,2134,1419,66.49,
2012,G,ARAPAHOE,6264103408,1490,515,2005,1365,68.08,
2012,G,ARAPAHOE,6264103409,729,360,1089,622,57.12,
2012,G,ARAPAHOE,6264103410,896,72,968,828,85.54,
2012,G,ARAPAHOE,6264103411,1357,545,1902,1153,60.62,
2012,G,ARAPAHOE,6264103412,457,119,576,404,70.14,
2012,G,ARAPAHOE,6264103413,945,459,1404,812,57.83,
2012,G,ARAPAHOE,6264103414,802,251,1053,716,68,
2012,G,ARAPAHOE,6264103415,0,0,0,0,0,
2012,G,ARAPAHOE,6264103416,1174,275,1449,1088,75.09,
2012,G,ARAPAHOE,6264103417,948,234,1182,862,72.93,
2012,G,ARAPAHOE,6264103418,791,130,921,740,80.35,
2012,G,ARAPAHOE,6264103419,874,168,1042,814,78.12,
2012,G,ARAPAHOE,6264103423,1161,257,1418,1072,75.6,
2012,G,ARAPAHOE,6264103425,1102,240,1342,1034,77.05,
2012,G,ARAPAHOE,6264103426,625,132,757,581,76.75,
2012,G,ARAPAHOE,6264103442,694,82,776,653,84.15,
2012,G,ARAPAHOE,6264103443,535,38,573,507,88.48,
2012,G,ARAPAHOE,6270303245,440,51,491,421,85.74,
2012,G,ARAPAHOE,6270303246,988,163,1151,919,79.84,
2012,G,ARAPAHOE,6270303247,1919,402,2321,1803,77.68,
2012,G,ARAPAHOE,6270303248,605,124,729,547,75.03,
2012,G,ARAPAHOE,6270303250,498,62,560,479,85.54,
2012,G,ARAPAHOE,6270303251,966,124,1090,933,85.6,
2012,G,ARAPAHOE,6270303252,1709,195,1904,1642,86.24,
2012,G,ARAPAHOE,6273603335,1209,303,1512,1143,75.6,
2012,G,ARAPAHOE,6273603336,1660,529,2189,1523,69.58,
2012,G,ARAPAHOE,6273603337,1095,295,1390,1015,73.02,
2012,G,ARAPAHOE,6273703218,804,203,1007,755,74.98,
2012,G,ARAPAHOE,6273703220,844,96,940,818,87.02,
2012,G,ARAPAHOE,6273703221,771,94,865,755,87.28,
2012,G,ARAPAHOE,6273703222,847,99,946,810,85.62,
2012,G,ARAPAHOE,6273703223,882,203,1085,827,76.22,
2012,G,ARAPAHOE,6273703224,793,104,897,750,83.61,
2012,G,ARAPAHOE,6273703225,902,126,1028,872,84.82,
2012,G,ARAPAHOE,6273703226,644,74,718,619,86.21,
2012,G,ARAPAHOE,6273703227,645,91,736,623,84.65,
2012,G,ARAPAHOE,6273703228,636,92,728,627,86.13,
2012,G,ARAPAHOE,6273703233,526,238,764,474,62.04,
2012,G,ARAPAHOE,6273703235,613,119,732,589,80.46,
2012,G,ARAPAHOE,6273703236,591,100,691,559,80.9,
2012,G,ARAPAHOE,6273703237,1071,161,1232,1026,83.28,
2012,G,ARAPAHOE,6273703238,779,139,918,745,81.15,
2012,G,ARAPAHOE,6273703239,789,114,903,775,85.83,
2012,G,ARAPAHOE,6273703240,1181,135,1316,1125,85.49,
2012,G,ARAPAHOE,6273703241,943,158,1101,915,83.11,
2012,G,ARAPAHOE,6273703242,725,67,792,688,86.87,
2012,G,ARAPAHOE,6273703243,1552,541,2093,1363,65.12,
2012,G,ARAPAHOE,6273703244,869,156,1025,822,80.2,
2012,G,ARAPAHOE,6273703257,1641,411,2052,1519,74.03,
2012,G,ARAPAHOE,6273703259,1670,704,2374,1468,61.84,
2012,G,ARAPAHOE,6273703260,1056,312,1368,985,72,
2012,G,ARAPAHOE,6273703261,1134,222,1356,1074,79.2,
2012,G,ARAPAHOE,6273703262,1137,221,1358,1099,80.93,
2012,G,ARAPAHOE,6273703263,897,159,1056,864,81.82,
2012,G,ARAPAHOE,6273703264,1081,221,1302,1023,78.57,
2012,G,ARAPAHOE,6273703274,986,181,1167,939,80.46,
2012,G,ARAPAHOE,6273703275,559,125,684,528,77.19,
2012,G,ARAPAHOE,6273703276,278,68,346,259,74.86,
2012,G,ARAPAHOE,6273703277,768,147,915,722,78.91,
2012,G,ARAPAHOE,6273703278,443,73,516,424,82.17,
2012,G,ARAPAHOE,6273703279,811,151,962,798,82.95,
2012,G,ARAPAHOE,6273703280,975,185,1160,933,80.43,
2012,G,ARAPAHOE,6273703281,1032,180,1212,967,79.79,
2012,G,ARAPAHOE,6273703282,1726,385,2111,1641,77.74,
2012,G,ARAPAHOE,6273703283,738,140,878,697,79.38,
2012,G,ARAPAHOE,6273703320,1275,350,1625,1203,74.03,
2012,G,ARAPAHOE,6273703321,1098,228,1326,1060,79.94,
2012,G,ARAPAHOE,6273703322,1029,155,1184,988,83.45,
2012,G,ARAPAHOE,6273703324,516,75,591,503,85.11,
2012,G,ARAPAHOE,6273703325,1536,200,1736,1486,85.6,
2012,G,ARAPAHOE,6273703328,265,47,312,255,81.73,
2012,G,ARAPAHOE,6273703331,1589,223,1812,1531,84.49,
2012,G,ARAPAHOE,6273703332,885,235,1120,842,75.18,
2012,G,ARAPAHOE,6273703333,609,186,795,584,73.46,
2012,G,ARAPAHOE,6273703334,1474,340,1814,1386,76.41,
2012,G,ARAPAHOE,6273703338,752,189,941,723,76.83,
2012,G,ARAPAHOE,6273703339,1013,275,1288,989,76.79,
2012,G,ARAPAHOE,6273703458,0,0,0,0,0,
2012,G,ARAPAHOE,6273803164,682,110,792,648,81.82,
2012,G,ARAPAHOE,6273803177,853,132,985,814,82.64,
2012,G,ARAPAHOE,6273803178,665,139,804,618,76.87,
2012,G,ARAPAHOE,6273803179,590,124,714,567,79.41,
2012,G,ARAPAHOE,6273803180,667,85,752,652,86.7,
2012,G,ARAPAHOE,6273803181,605,104,709,572,80.68,
2012,G,ARAPAHOE,6273803182,801,123,924,762,82.47,
2012,G,ARAPAHOE,6273803183,1111,180,1291,1061,82.18,
2012,G,ARAPAHOE,6273803184,657,82,739,636,86.06,
2012,G,ARAPAHOE,6273803185,807,169,976,778,79.71,
2012,G,ARAPAHOE,6273803186,859,105,964,845,87.66,
2012,G,ARAPAHOE,6273803187,812,132,944,783,82.94,
2012,G,ARAPAHOE,6273803188,580,76,656,555,84.6,
2012,G,ARAPAHOE,6273803189,1006,123,1129,977,86.54,
2012,G,ARAPAHOE,6273803190,1048,283,1331,1006,75.58,
2012,G,ARAPAHOE,6273803191,1051,147,1198,1030,85.98,
2012,G,ARAPAHOE,6273803192,1000,141,1141,971,85.1,
2012,G,ARAPAHOE,6273803193,781,131,912,759,83.22,
2012,G,ARAPAHOE,6273803194,1073,152,1225,1020,83.27,
2012,G,ARAPAHOE,6273803195,966,98,1064,938,88.16,
2012,G,ARAPAHOE,6273803196,592,58,650,579,89.08,
2012,G,ARAPAHOE,6273803197,635,73,708,615,86.86,
2012,G,ARAPAHOE,6273803205,585,103,688,555,80.67,
2012,G,ARAPAHOE,6273803206,680,116,796,677,85.05,
2012,G,ARAPAHOE,6273803207,979,160,1139,931,81.74,
2012,G,ARAPAHOE,6273803208,997,155,1152,958,83.16,
2012,G,ARAPAHOE,6273803209,949,107,1056,904,85.61,
2012,G,ARAPAHOE,6273803210,1346,200,1546,1287,83.25,
2012,G,ARAPAHOE,6273803211,762,162,924,729,78.9,
2012,G,ARAPAHOE,6273803212,1132,247,1379,1065,77.23,
2012,G,ARAPAHOE,6273803213,920,151,1071,873,81.51,
2012,G,ARAPAHOE,6273803214,774,102,876,771,88.01,
2012,G,ARAPAHOE,6273803215,640,56,696,632,90.8,
2012,G,ARAPAHOE,6273803216,872,99,971,836,86.1,
2012,G,ARAPAHOE,6273803217,797,99,896,776,86.61,
2012,G,ARAPAHOE,6273803219,1094,102,1196,1049,87.71,
2012,G,ARAPAHOE,6274003457,3,0,3,0,0,
2012,G,ARAPAHOE,6283603340,1799,358,2157,1690,78.35,
2012,G,ARAPAHOE,6283603341,1721,343,2064,1635,79.22,
2012,G,ARAPAHOE,6283603342,1318,382,1700,1265,74.41,
2012,G,ARAPAHOE,6283603343,1247,259,1506,1158,76.89,
2012,G,ARAPAHOE,6283603344,1846,367,2213,1783,80.57,
2012,G,ARAPAHOE,6283603349,0,0,0,0,0,
2012,G,ARAPAHOE,6283603351,2321,477,2798,2179,77.88,
2012,G,ARAPAHOE,6283603561,0,0,0,0,0,
2012,G,ARAPAHOE,6284003265,781,241,1022,718,70.25,
2012,G,ARAPAHOE,6284003266,882,246,1128,854,75.71,
2012,G,ARAPAHOE,6284003267,872,236,1108,852,76.9,
2012,G,ARAPAHOE,6284003268,672,156,828,620,74.88,
2012,G,ARAPAHOE,6284003269,779,243,1022,718,70.25,
2012,G,ARAPAHOE,6284003270,745,244,989,682,68.96,
2012,G,ARAPAHOE,6284003271,614,192,806,564,69.98,
2012,G,ARAPAHOE,6284003272,697,150,847,662,78.16,
2012,G,ARAPAHOE,6284003273,673,175,848,634,74.76,
2012,G,ARAPAHOE,6284003302,1047,210,1257,983,78.2,
2012,G,ARAPAHOE,6284003303,769,161,930,724,77.85,
2012,G,ARAPAHOE,6284003304,696,217,913,646,70.76,
2012,G,ARAPAHOE,6284003305,1079,261,1340,1004,74.93,
2012,G,ARAPAHOE,6284003306,707,175,882,677,76.76,
2012,G,ARAPAHOE,6284003307,607,304,911,498,54.67,
2012,G,ARAPAHOE,6284003308,887,263,1150,838,72.87,
2012,G,ARAPAHOE,6284003309,1074,258,1332,978,73.42,
2012,G,ARAPAHOE,6284003310,1235,308,1543,1163,75.37,
2012,G,ARAPAHOE,6284003311,1770,461,2231,1674,75.03,
2012,G,ARAPAHOE,6284003312,746,230,976,699,71.62,
2012,G,ARAPAHOE,6284003313,875,218,1093,814,74.47,
2012,G,ARAPAHOE,6284003314,617,141,758,572,75.46,
2012,G,ARAPAHOE,6284003315,1207,321,1528,1144,74.87,
2012,G,ARAPAHOE,6284003316,589,137,726,561,77.27,
2012,G,ARAPAHOE,6284003317,817,266,1083,773,71.38,
2012,G,ARAPAHOE,6284003318,724,219,943,675,71.58,
2012,G,ARAPAHOE,6284003319,698,212,910,633,69.56,
2012,G,ARAPAHOE,6284003446,712,156,868,659,75.92,
2012,G,ARAPAHOE,6284003447,723,238,961,656,68.26,
2012,G,ARAPAHOE,6284003448,1361,420,1781,1266,71.08,
2012,G,ARAPAHOE,6284003449,579,141,720,552,76.67,
2012,G,ARAPAHOE,6284003450,1591,544,2135,1448,67.82,
2012,G,ARAPAHOE,6284003451,384,127,511,366,71.62,
2012,G,ARAPAHOE,6284003452,697,129,826,650,78.69,
2012,G,ARAPAHOE,6284003454,896,215,1111,862,77.59,
2012,G,ARAPAHOE,6284003456,1007,205,1212,936,77.23,
2012,G,ARAPAHOE,6284003459,659,204,863,608,70.45,
2012,G,ARAPAHOE,6284003460,888,260,1148,820,71.43,
2012,G,ARAPAHOE,6284003461,1015,281,1296,953,73.53,
2012,G,ARAPAHOE,6284003462,982,211,1193,927,77.7,
2012,G,ARAPAHOE,6284003463,1172,279,1451,1101,75.88,
2012,G,ARAPAHOE,6284003464,764,167,931,705,75.73,
2012,G,ARAPAHOE,6284003472,1032,429,1461,887,60.71,
2012,G,ARAPAHOE,6284003473,1358,460,1818,1253,68.92,
2012,G,ARAPAHOE,6284103301,547,120,667,494,74.06,
2012,G,ARAPAHOE,6284103420,1419,366,1785,1241,69.52,
2012,G,ARAPAHOE,6284103421,483,59,542,454,83.76,
2012,G,ARAPAHOE,6284103422,534,138,672,503,74.85,
2012,G,ARAPAHOE,6284103427,1309,198,1507,1205,79.96,
2012,G,ARAPAHOE,6284103428,872,175,1047,802,76.6,
2012,G,ARAPAHOE,6284103429,819,244,1063,729,68.58,
2012,G,ARAPAHOE,6284103430,913,280,1193,833,69.82,
2012,G,ARAPAHOE,6284103431,488,119,607,441,72.65,
2012,G,ARAPAHOE,6284103432,996,273,1269,876,69.03,
2012,G,ARAPAHOE,6284103433,794,224,1018,720,70.73,
2012,G,ARAPAHOE,6284103437,1100,288,1388,1010,72.77,
2012,G,ARAPAHOE,6284103438,738,165,903,690,76.41,
2012,G,ARAPAHOE,6284103439,843,160,1003,791,78.86,
2012,G,ARAPAHOE,6284103440,809,65,874,765,87.53,
2012,G,ARAPAHOE,6284103441,794,97,891,758,85.07,
2012,G,ARAPAHOE,6284103444,621,122,743,558,75.1,
2012,G,ARAPAHOE,6284103445,544,136,680,502,73.82,
2012,G,ARAPAHOE,6284103465,531,96,627,509,81.18,
2012,G,ARAPAHOE,6284103466,701,191,892,635,71.19,
2012,G,ARAPAHOE,6284103467,745,212,957,668,69.8,
2012,G,ARAPAHOE,6284103468,683,158,841,631,75.03,
2012,G,ARAPAHOE,6284103469,605,243,848,538,63.44,
2012,G,ARAPAHOE,6284103470,948,299,1247,818,65.6,
2012,G,ARAPAHOE,6284103471,809,251,1060,754,71.13,
2012,G,ARAPAHOE,6284203434,936,244,1180,855,72.46,
2012,G,ARAPAHOE,6284203435,1137,325,1462,997,68.19,
2012,G,ARAPAHOE,6284203436,1234,422,1656,1014,61.23,
2012,G,ARAPAHOE,6285603352,2012,257,2269,1917,84.49,
2012,G,ARAPAHOE,6293603345,1619,400,2019,1530,75.78,
2012,G,ARAPAHOE,6293603346,84,14,98,74,75.51,
2012,G,ARAPAHOE,6293603347,1901,440,2341,1693,72.32,
2012,G,ARAPAHOE,6293603360,0,0,0,0,0,
2012,G,ARAPAHOE,6293603361,0,0,0,0,0,
2012,G,ARAPAHOE,6293603474,560,168,728,510,70.05,
2012,G,ARAPAHOE,6293603537,857,267,1124,775,68.95,
2012,G,ARAPAHOE,6293603538,928,258,1186,862,72.68,
2012,G,ARAPAHOE,6293603539,900,326,1226,814,66.39,
2012,G,ARAPAHOE,6293603540,581,145,726,538,74.1,
2012,G,ARAPAHOE,6293603541,601,216,817,532,65.12,
2012,G,ARAPAHOE,6293603542,710,342,1052,556,52.85,
2012,G,ARAPAHOE,6293603543,785,184,969,722,74.51,
2012,G,ARAPAHOE,6293603544,1041,512,1553,870,56.02,
2012,G,ARAPAHOE,6293603545,319,154,473,264,55.81,
2012,G,ARAPAHOE,6293603546,883,242,1125,757,67.29,
2012,G,ARAPAHOE,6293603547,796,211,1007,711,70.61,
2012,G,ARAPAHOE,6293603548,441,234,675,338,50.07,
2012,G,ARAPAHOE,6293603549,426,170,596,373,62.58,
2012,G,ARAPAHOE,6293603550,69,22,91,61,67.03,
2012,G,ARAPAHOE,6293603551,663,283,946,572,60.47,
2012,G,ARAPAHOE,6293603552,603,273,876,530,60.5,
2012,G,ARAPAHOE,6293603553,1096,420,1516,974,64.25,
2012,G,ARAPAHOE,6293603554,877,219,1096,838,76.46,
2012,G,ARAPAHOE,6293603555,728,217,945,671,71.01,
2012,G,ARAPAHOE,6293603556,996,265,1261,912,72.32,
2012,G,ARAPAHOE,6293603557,1371,421,1792,1289,71.93,
2012,G,ARAPAHOE,6293603558,776,251,1027,720,70.11,
2012,G,ARAPAHOE,6293603559,733,197,930,689,74.09,
2012,G,ARAPAHOE,6293603560,347,112,459,315,68.63,
2012,G,ARAPAHOE,6294203503,1274,522,1796,1042,58.02,
2012,G,ARAPAHOE,6294203504,677,246,923,590,63.92,
2012,G,ARAPAHOE,6294203505,740,293,1033,598,57.89,
2012,G,ARAPAHOE,6294203506,1096,512,1608,823,51.18,
2012,G,ARAPAHOE,6294203507,653,223,876,575,65.64,
2012,G,ARAPAHOE,6294203508,517,170,687,439,63.9,
2012,G,ARAPAHOE,6294203509,475,127,602,431,71.59,
2012,G,ARAPAHOE,6294203510,566,100,666,535,80.33,
2012,G,ARAPAHOE,6294203511,923,442,1365,764,55.97,
2012,G,ARAPAHOE,6294203512,824,302,1126,719,63.85,
2012,G,ARAPAHOE,6294203513,750,260,1010,661,65.45,
2012,G,ARAPAHOE,6294203514,645,276,921,537,58.31,
2012,G,ARAPAHOE,6294203515,753,181,934,722,77.3,
2012,G,ARAPAHOE,6294203516,542,155,697,477,68.44,
2012,G,ARAPAHOE,6294203517,595,205,800,521,65.13,
2012,G,ARAPAHOE,6294203518,580,189,769,506,65.8,
2012,G,ARAPAHOE,6294203519,587,226,813,510,62.73,
2012,G,ARAPAHOE,6294203520,801,183,984,737,74.9,
2012,G,ARAPAHOE,6294203521,652,182,834,592,70.98,
2012,G,ARAPAHOE,6294203522,844,195,1039,752,72.38,
2012,G,ARAPAHOE,6294203523,1114,231,1345,981,72.94,
2012,G,ARAPAHOE,6294203524,774,222,996,654,65.66,
2012,G,ARAPAHOE,6294203525,742,224,966,634,65.63,
2012,G,ARAPAHOE,6294203526,670,177,847,585,69.07,
2012,G,ARAPAHOE,6294203527,992,305,1297,848,65.38,
2012,G,ARAPAHOE,6294203528,349,158,507,306,60.36,
2012,G,ARAPAHOE,6294203529,296,135,431,224,51.97,
2012,G,ARAPAHOE,6294203530,756,315,1071,614,57.33,
2012,G,ARAPAHOE,6294203531,622,206,828,567,68.48,
2012,G,ARAPAHOE,6294203532,840,273,1113,681,61.19,
2012,G,ARAPAHOE,6294203533,1185,459,1644,957,58.21,
2012,G,ARAPAHOE,6294203534,840,451,1291,686,53.14,
2012,G,ARAPAHOE,6294203535,724,139,863,647,74.97,
2012,G,ARAPAHOE,6294203536,715,308,1023,577,56.4,
2012,G,ARAPAHOE,6295603326,1322,99,1421,1272,89.51,
2012,G,ARAPAHOE,6295603327,1054,230,1284,980,76.32,
2012,G,ARAPAHOE,6295603329,1641,449,2090,1513,72.39,
2012,G,ARAPAHOE,6295603330,1375,279,1654,1309,79.14,
2012,G,ARAPAHOE,6295603353,1142,169,1311,1096,83.6,
2012,G,ARAPAHOE,6295603354,1782,270,2052,1649,80.36,
2012,G,ARAPAHOE,6295603355,1228,162,1390,1174,84.46,
2012,G,ARAPAHOE,6295603356,1550,161,1711,1503,87.84,
2012,G,ARCHULETA,3065904001,783,270,1053,784,74.45,
2012,G,ARCHULETA,3065904002,766,293,1059,742,70.07,
2012,G,ARCHULETA,3065904003,637,202,839,616,73.42,
2012,G,ARCHULETA,3065904004,331,126,457,304,66.52,
2012,G,ARCHULETA,3065904005,405,188,593,403,67.96,
2012,G,ARCHULETA,3065904006,1637,714,2351,1546,65.76,
2012,G,ARCHULETA,3065904007,1242,622,1864,1137,61,
2012,G,ARCHULETA,3065904008,1394,569,1963,1273,64.85,
2012,G,BACA,4356405001,295,63,358,272,75.98,
2012,G,BACA,4356405002,315,80,395,290,73.42,
2012,G,BACA,4356405003,169,52,221,161,72.85,
2012,G,BACA,4356405004,348,112,460,313,68.04,
2012,G,BACA,4356405005,141,39,180,132,73.33,
2012,G,BACA,4356405006,170,54,224,150,66.96,
2012,G,BACA,4356405007,398,98,496,359,72.38,
2012,G,BACA,4356405008,405,110,515,368,71.46,
2012,G,BACA,4356405009,101,13,114,94,82.46,
2012,G,BENT,4356406001,303,78,381,281,73.75,
2012,G,BENT,4356406002,468,104,572,439,76.75,
2012,G,BENT,4356406003,494,218,712,458,64.33,
2012,G,BENT,4356406004,404,180,584,373,63.87,
2012,G,BENT,4356406005,452,126,578,420,72.66,
2012,G,BOULDER,2161307900,456,114,570,453,79.47,
2012,G,BOULDER,2161307901,605,169,774,582,75.19,
2012,G,BOULDER,2161307902,238,71,309,233,75.4,
2012,G,BOULDER,2163307100,1045,325,1370,1032,75.33,
2012,G,BOULDER,2163307101,1068,299,1367,1040,76.08,
2012,G,BOULDER,2163307102,932,860,1792,857,47.82,
2012,G,BOULDER,2163307103,980,204,1184,954,80.57,
2012,G,BOULDER,2163307104,978,220,1198,953,79.55,
2012,G,BOULDER,2163307105,403,187,590,377,63.9,
2012,G,BOULDER,2163307106,861,192,1053,852,80.91,
2012,G,BOULDER,2163307107,520,172,692,498,71.97,
2012,G,BOULDER,2171207200,575,91,666,560,84.08,
2012,G,BOULDER,2171207201,548,128,676,541,80.03,
2012,G,BOULDER,2171207202,1030,284,1314,974,74.12,
2012,G,BOULDER,2171207203,936,115,1051,910,86.58,
2012,G,BOULDER,2171207204,927,213,1140,896,78.6,
2012,G,BOULDER,2171207205,874,211,1085,861,79.35,
2012,G,BOULDER,2171207206,566,94,660,554,83.94,
2012,G,BOULDER,2171207207,922,202,1124,882,78.47,
2012,G,BOULDER,2171207208,986,184,1170,955,81.62,
2012,G,BOULDER,2171207209,569,100,669,566,84.6,
2012,G,BOULDER,2171207210,849,151,1000,822,82.2,
2012,G,BOULDER,2171207211,1039,244,1283,997,77.71,
2012,G,BOULDER,2171207212,751,194,945,723,76.51,
2012,G,BOULDER,2171207213,1261,216,1477,1219,82.53,
2012,G,BOULDER,2171207214,1183,245,1428,1158,81.09,
2012,G,BOULDER,2171207300,1060,214,1274,1015,79.67,
2012,G,BOULDER,2171207301,1143,337,1480,1055,71.28,
2012,G,BOULDER,2171207302,1022,291,1313,1003,76.39,
2012,G,BOULDER,2171207303,748,244,992,730,73.59,
2012,G,BOULDER,2171207304,826,145,971,785,80.84,
2012,G,BOULDER,2171207305,972,290,1262,930,73.69,
2012,G,BOULDER,2171207306,988,270,1258,962,76.47,
2012,G,BOULDER,2171207307,808,370,1178,763,64.77,
2012,G,BOULDER,2171207308,766,260,1026,741,72.22,
2012,G,BOULDER,2171207309,1249,283,1532,1179,76.96,
2012,G,BOULDER,2171207310,794,172,966,752,77.85,
2012,G,BOULDER,2171207311,634,207,841,607,72.18,
2012,G,BOULDER,2171207312,897,135,1032,869,84.21,
2012,G,BOULDER,2171207313,1185,213,1398,1154,82.55,
2012,G,BOULDER,2171207314,866,136,1002,839,83.73,
2012,G,BOULDER,2171207315,719,178,897,699,77.93,
2012,G,BOULDER,2171207316,1047,164,1211,1021,84.31,
2012,G,BOULDER,2171207407,426,74,500,411,82.2,
2012,G,BOULDER,2173307400,119,12,131,117,89.31,
2012,G,BOULDER,2173307408,1043,196,1239,1009,81.44,
2012,G,BOULDER,2173307409,1205,237,1442,1164,80.72,
2012,G,BOULDER,2173307410,979,164,1143,956,83.64,
2012,G,BOULDER,2173307411,1413,293,1706,1382,81.01,
2012,G,BOULDER,2173307412,1315,261,1576,1267,80.39,
2012,G,BOULDER,2181007500,805,203,1008,774,76.79,
2012,G,BOULDER,2181007501,860,133,993,821,82.68,
2012,G,BOULDER,2181007502,958,149,1107,931,84.1,
2012,G,BOULDER,2181007503,1361,194,1555,1350,86.82,
2012,G,BOULDER,2181007504,672,102,774,648,83.72,
2012,G,BOULDER,2181007800,815,156,971,781,80.43,
2012,G,BOULDER,2181007801,486,100,586,472,80.55,
2012,G,BOULDER,2181007802,657,391,1048,640,61.07,
2012,G,BOULDER,2181007803,883,387,1270,854,67.24,
2012,G,BOULDER,2181007804,1204,233,1437,1175,81.77,
2012,G,BOULDER,2181007805,459,89,548,430,78.47,
2012,G,BOULDER,2181007806,967,305,1272,933,73.35,
2012,G,BOULDER,2181007807,985,188,1173,948,80.82,
2012,G,BOULDER,2181007808,1567,450,2017,1492,73.97,
2012,G,BOULDER,2181007809,982,224,1206,943,78.19,
2012,G,BOULDER,2181007810,970,172,1142,933,81.7,
2012,G,BOULDER,2181007811,1165,206,1371,1128,82.28,
2012,G,BOULDER,2181007812,809,145,954,782,81.97,
2012,G,BOULDER,2181007813,767,276,1043,731,70.09,
2012,G,BOULDER,2181007814,1030,272,1302,991,76.11,
2012,G,BOULDER,2181007815,749,443,1192,703,58.98,
2012,G,BOULDER,2181007816,1074,360,1434,1021,71.2,
2012,G,BOULDER,2181007817,808,145,953,776,81.43,
2012,G,BOULDER,2181007818,1002,218,1220,977,80.08,
2012,G,BOULDER,2181007819,838,216,1054,793,75.24,
2012,G,BOULDER,2181007820,710,158,868,685,78.92,
2012,G,BOULDER,2181007821,1022,427,1449,1002,69.15,
2012,G,BOULDER,2181007822,900,405,1305,844,64.67,
2012,G,BOULDER,2181007823,1305,521,1826,1216,66.59,
2012,G,BOULDER,2181007824,950,367,1317,905,68.72,
2012,G,BOULDER,2181007825,546,155,701,527,75.18,
2012,G,BOULDER,2181007826,795,283,1078,772,71.61,
2012,G,BOULDER,2181007827,854,461,1315,818,62.21,
2012,G,BOULDER,2181007828,692,399,1091,664,60.86,
2012,G,BOULDER,2181007829,768,512,1280,722,56.41,
2012,G,BOULDER,2181007830,707,611,1318,663,50.3,
2012,G,BOULDER,2181007831,812,702,1514,767,50.66,
2012,G,BOULDER,2181007832,333,187,520,325,62.5,
2012,G,BOULDER,2181007833,735,864,1599,684,42.78,
2012,G,BOULDER,2181007834,1501,1326,2827,1366,48.32,
2012,G,BOULDER,2181007835,525,493,1018,464,45.58,
2012,G,BOULDER,2181007836,495,297,792,461,58.21,
2012,G,BOULDER,2181007837,828,650,1478,713,48.24,
2012,G,BOULDER,2181007838,446,348,794,416,52.39,
2012,G,BOULDER,2181007839,588,120,708,556,78.53,
2012,G,BOULDER,2181007840,582,178,760,555,73.03,
2012,G,BOULDER,2181007841,691,164,855,668,78.13,
2012,G,BOULDER,2181007842,816,188,1004,775,77.19,
2012,G,BOULDER,2181007843,1194,226,1420,1165,82.04,
2012,G,BOULDER,2181007844,676,233,909,650,71.51,
2012,G,BOULDER,2181007845,799,389,1188,746,62.79,
2012,G,BOULDER,2181007846,874,572,1446,789,54.56,
2012,G,BOULDER,2181007847,663,494,1157,608,52.55,
2012,G,BOULDER,2181007848,637,309,946,586,61.95,
2012,G,BOULDER,2181007849,1069,1158,2227,976,43.83,
2012,G,BOULDER,2181007850,632,85,717,610,85.08,
2012,G,BOULDER,2181007851,1020,294,1314,953,72.53,
2012,G,BOULDER,2181007852,1320,421,1741,1265,72.66,
2012,G,BOULDER,2181007853,770,345,1115,718,64.39,
2012,G,BOULDER,2181107505,720,176,896,691,77.12,
2012,G,BOULDER,2181107506,570,73,643,550,85.54,
2012,G,BOULDER,2181107507,1055,160,1215,1030,84.77,
2012,G,BOULDER,2181107508,682,132,814,674,82.8,
2012,G,BOULDER,2181107700,882,128,1010,861,85.25,
2012,G,BOULDER,2181107701,509,55,564,488,86.52,
2012,G,BOULDER,2181107702,279,42,321,271,84.42,
2012,G,BOULDER,2181107703,431,64,495,426,86.06,
2012,G,BOULDER,2181107704,292,77,369,303,82.11,
2012,G,BOULDER,2181107705,571,106,677,558,82.42,
2012,G,BOULDER,2181107912,1034,188,1222,1009,82.57,
2012,G,BOULDER,2181107913,628,131,759,605,79.71,
2012,G,BOULDER,2181107916,406,100,506,392,77.47,
2012,G,BOULDER,2181107917,1197,249,1446,1181,81.67,
2012,G,BOULDER,2181107918,992,244,1236,983,79.53,
2012,G,BOULDER,2181207401,601,105,706,566,80.17,
2012,G,BOULDER,2181207402,600,91,691,588,85.09,
2012,G,BOULDER,2181207403,885,164,1049,852,81.22,
2012,G,BOULDER,2181207404,846,142,988,818,82.79,
2012,G,BOULDER,2181207405,435,64,499,416,83.37,
2012,G,BOULDER,2181207406,642,107,749,634,84.65,
2012,G,BOULDER,2181307854,758,404,1162,699,60.15,
2012,G,BOULDER,2181307855,802,341,1143,742,64.92,
2012,G,BOULDER,2181307856,568,172,740,532,71.89,
2012,G,BOULDER,2181307857,808,180,988,783,79.25,
2012,G,BOULDER,2181307858,904,198,1102,884,80.22,
2012,G,BOULDER,2181307859,818,111,929,790,85.04,
2012,G,BOULDER,2181307860,641,103,744,614,82.53,
2012,G,BOULDER,2181307861,591,123,714,569,79.69,
2012,G,BOULDER,2181307862,629,137,766,617,80.55,
2012,G,BOULDER,2181307863,740,154,894,710,79.42,
2012,G,BOULDER,2181307864,633,152,785,602,76.69,
2012,G,BOULDER,2181307865,606,281,887,585,65.95,
2012,G,BOULDER,2181307866,824,287,1111,766,68.95,
2012,G,BOULDER,2181307867,751,322,1073,699,65.14,
2012,G,BOULDER,2181307868,827,136,963,792,82.24,
2012,G,BOULDER,2181307869,559,170,729,545,74.76,
2012,G,BOULDER,2181307870,626,267,893,586,65.62,
2012,G,BOULDER,2181307871,794,430,1224,734,59.97,
2012,G,BOULDER,2181307872,786,800,1586,726,45.78,
2012,G,BOULDER,2181307873,448,100,548,424,77.37,
2012,G,BOULDER,2181307874,967,342,1309,897,68.53,
2012,G,BOULDER,2181307875,713,657,1370,616,44.96,
2012,G,BOULDER,2181307876,832,872,1704,729,42.78,
2012,G,BOULDER,2181307877,734,339,1073,687,64.03,
2012,G,BOULDER,2181307878,726,536,1262,681,53.96,
2012,G,BOULDER,2181307879,737,560,1297,700,53.97,
2012,G,BOULDER,2181307880,994,1149,2143,875,40.83,
2012,G,BOULDER,2181307881,620,323,943,590,62.57,
2012,G,BOULDER,2181307882,663,187,850,623,73.29,
2012,G,BOULDER,2181307883,740,302,1042,730,70.06,
2012,G,BOULDER,2181307884,897,515,1412,819,58,
2012,G,BOULDER,2181307885,608,172,780,596,76.41,
2012,G,BOULDER,2181307886,772,165,937,753,80.36,
2012,G,BOULDER,2181307887,982,168,1150,940,81.74,
2012,G,BOULDER,2181307888,808,114,922,774,83.95,
2012,G,BOULDER,2181307903,1609,602,2211,1548,70.01,
2012,G,BOULDER,2181307904,465,93,558,438,78.49,
2012,G,BOULDER,2181307905,256,47,303,247,81.52,
2012,G,BOULDER,2181307906,501,76,577,488,84.58,
2012,G,BOULDER,2181307907,43,11,54,41,75.93,
2012,G,BOULDER,2181307908,860,182,1042,834,80.04,
2012,G,BOULDER,2181307909,503,149,652,478,73.31,
2012,G,BOULDER,2181307910,698,146,844,659,78.08,
2012,G,BOULDER,2181307911,878,170,1048,845,80.63,
2012,G,BOULDER,2181307914,562,137,699,552,78.97,
2012,G,BOULDER,2181307915,307,118,425,312,73.41,
2012,G,BOULDER,4171107616,940,181,1121,930,82.96,
2012,G,BOULDER,4171107617,1459,417,1876,1404,74.84,
2012,G,BOULDER,4171107618,1014,175,1189,1000,84.1,
2012,G,BOULDER,4171107619,1169,471,1640,1089,66.4,
2012,G,BOULDER,4171107620,1305,387,1692,1236,73.05,
2012,G,BOULDER,4171107621,917,225,1142,876,76.71,
2012,G,BOULDER,4171107622,608,217,825,576,69.82,
2012,G,BOULDER,4171107623,987,423,1410,935,66.31,
2012,G,BOULDER,4171107624,664,218,882,632,71.66,
2012,G,BOULDER,4171107625,762,166,928,740,79.74,
2012,G,BOULDER,4171107626,984,202,1186,940,79.26,
2012,G,BOULDER,4171107627,652,300,952,615,64.6,
2012,G,BOULDER,4171107628,732,148,880,698,79.32,
2012,G,BOULDER,4171107629,509,173,682,487,71.41,
2012,G,BOULDER,4171107630,787,255,1042,710,68.14,
2012,G,BOULDER,4171107631,513,177,690,486,70.43,
2012,G,BOULDER,4171107632,1035,264,1299,991,76.29,
2012,G,BOULDER,4171107633,707,288,995,615,61.81,
2012,G,BOULDER,4171107634,697,245,942,641,68.05,
2012,G,BOULDER,4171107635,748,178,926,727,78.51,
2012,G,BOULDER,4171107636,1006,231,1237,977,78.98,
2012,G,BOULDER,4171107637,1143,318,1461,1082,74.06,
2012,G,BOULDER,4171107638,919,110,1029,890,86.49,
2012,G,BOULDER,4171107639,810,132,942,787,83.55,
2012,G,BOULDER,4171107640,793,172,965,758,78.55,
2012,G,BOULDER,4171107641,713,190,903,686,75.97,
2012,G,BOULDER,4171107642,971,298,1269,917,72.26,
2012,G,BOULDER,4171107643,652,231,883,617,69.88,
2012,G,BOULDER,4171107644,702,290,992,622,62.7,
2012,G,BOULDER,4171107645,737,200,937,705,75.24,
2012,G,BOULDER,4171107646,828,183,1011,797,78.83,
2012,G,BOULDER,4171107647,896,187,1083,899,83.01,
2012,G,BOULDER,4171107648,852,325,1177,775,65.85,
2012,G,BOULDER,4171107649,636,253,889,587,66.03,
2012,G,BOULDER,4171107650,696,228,924,641,69.37,
2012,G,BOULDER,4171107651,861,223,1084,840,77.49,
2012,G,BOULDER,4171107652,841,362,1203,838,69.66,
2012,G,BOULDER,4171107653,654,103,757,648,85.6,
2012,G,BOULDER,4171107654,1212,432,1644,1172,71.29,
2012,G,BOULDER,4171207600,1332,300,1632,1270,77.82,
2012,G,BOULDER,4171207601,1108,248,1356,1075,79.28,
2012,G,BOULDER,4171207602,784,212,996,651,65.36,
2012,G,BOULDER,4171207603,1030,159,1189,1098,92.35,
2012,G,BOULDER,4171207604,865,163,1028,830,80.74,
2012,G,BOULDER,4171207605,896,282,1178,833,70.71,
2012,G,BOULDER,4171207606,684,253,937,657,70.12,
2012,G,BOULDER,4171207607,886,211,1097,863,78.67,
2012,G,BOULDER,4171207608,804,332,1136,712,62.68,
2012,G,BOULDER,4171207609,441,195,636,404,63.52,
2012,G,BOULDER,4171207610,1156,456,1612,1063,65.94,
2012,G,BOULDER,4171207611,925,276,1201,869,72.36,
2012,G,BOULDER,4171207612,790,194,984,765,77.74,
2012,G,BOULDER,4171207613,736,185,921,706,76.66,
2012,G,BOULDER,4171207614,1167,251,1418,1128,79.55,
2012,G,BOULDER,4171207615,703,152,855,699,81.75,
2012,G,BOULDER,4181107706,164,23,187,163,87.17,
2012,G,BOULDER,4181107707,528,75,603,510,84.58,
2012,G,BOULDER,4181107708,605,117,722,583,80.75,
2012,G,BROOMFIELD,2233364001,295,187,482,254,52.7,
2012,G,BROOMFIELD,2233364002,805,479,1284,707,55.06,
2012,G,BROOMFIELD,2233364003,833,135,968,727,75.1,
2012,G,BROOMFIELD,2233364004,1140,369,1509,1073,71.11,
2012,G,BROOMFIELD,2233364005,463,143,606,430,70.96,
2012,G,BROOMFIELD,2233364006,383,178,561,348,62.03,
2012,G,BROOMFIELD,2233364007,723,276,999,662,66.27,
2012,G,BROOMFIELD,2233364008,584,213,797,551,69.13,
2012,G,BROOMFIELD,2233364009,765,153,918,715,77.89,
2012,G,BROOMFIELD,2233364010,1010,200,1210,968,80,
2012,G,BROOMFIELD,2233364011,987,204,1191,931,78.17,
2012,G,BROOMFIELD,2233364012,1141,113,1254,1101,87.8,
2012,G,BROOMFIELD,2233364013,845,280,1125,813,72.27,
2012,G,BROOMFIELD,2233364014,950,179,1129,897,79.45,
2012,G,BROOMFIELD,2233364015,1067,210,1277,1031,80.74,
2012,G,BROOMFIELD,2233364016,1038,143,1181,993,84.08,
2012,G,BROOMFIELD,2233364017,1072,165,1237,1046,84.56,
2012,G,BROOMFIELD,2233364018,674,273,947,623,65.79,
2012,G,BROOMFIELD,2233364019,1099,375,1474,1014,68.79,
2012,G,BROOMFIELD,2233364020,1047,223,1270,992,78.11,
2012,G,BROOMFIELD,2233364021,1553,469,2022,1473,72.85,
2012,G,BROOMFIELD,2233364022,627,178,805,602,74.78,
2012,G,BROOMFIELD,2233364023,691,147,838,669,79.83,
2012,G,BROOMFIELD,2233364024,1426,241,1667,1344,80.62,
2012,G,BROOMFIELD,2233364025,2124,465,2589,2027,78.29,
2012,G,BROOMFIELD,2233364026,835,116,951,810,85.17,
2012,G,BROOMFIELD,2233364027,1310,271,1581,1235,78.12,
2012,G,BROOMFIELD,2233364028,804,382,1186,717,60.46,
2012,G,BROOMFIELD,2233364029,955,277,1232,892,72.4,
2012,G,BROOMFIELD,2233364030,906,265,1171,853,72.84,
2012,G,BROOMFIELD,2233364031,802,223,1025,744,72.59,
2012,G,BROOMFIELD,2233364032,1509,348,1857,1449,78.03,
2012,G,BROOMFIELD,2233364033,1243,308,1551,1187,76.53,
2012,G,BROOMFIELD,2233364034,421,41,462,415,89.83,
2012,G,BROOMFIELD,2233364035,2261,244,2505,2200,87.82,
2012,G,BROOMFIELD,2233364036,6,8,14,0,0,
2012,G,BROOMFIELD,2233364037,5,0,5,0,0,
2012,G,BROOMFIELD,2233364038,13,4,17,10,58.82,
2012,G,CHAFFEE,5056008001,527,116,643,508,79,
2012,G,CHAFFEE,5056008002,588,174,762,536,70.34,
2012,G,CHAFFEE,5056008003,885,269,1154,813,70.45,
2012,G,CHAFFEE,5056008004,868,193,1061,823,77.57,
2012,G,CHAFFEE,5056008005,841,154,995,801,80.5,
2012,G,CHAFFEE,5056008006,859,152,1011,824,81.5,
2012,G,CHAFFEE,5056008007,1167,279,1446,1108,76.63,
2012,G,CHAFFEE,5056008008,668,176,844,648,76.78,
2012,G,CHAFFEE,5056008009,743,143,886,718,81.04,
2012,G,CHAFFEE,5056008010,835,180,1015,796,78.42,
2012,G,CHAFFEE,5056008011,680,147,827,640,77.39,
2012,G,CHAFFEE,5056008012,616,140,756,582,76.98,
2012,G,CHAFFEE,5056008013,827,143,970,782,80.62,
2012,G,CHAFFEE,5056008014,579,112,691,550,79.59,
2012,G,CHAFFEE,5056008015,468,95,563,440,78.15,
2012,G,CHEYENNE,4016509001,133,41,174,127,72.99,
2012,G,CHEYENNE,4016509002,336,101,437,316,72.31,
2012,G,CHEYENNE,4016509003,381,94,475,358,75.37,
2012,G,CHEYENNE,4016509004,252,54,306,247,80.72,
2012,G,CHEYENNE,4016509005,65,11,76,64,84.21,
2012,G,CLEAR CREEK,2021310001,791,313,1104,733,66.39,
2012,G,CLEAR CREEK,2021310002,311,144,455,280,61.54,
2012,G,CLEAR CREEK,2021310003,361,121,482,358,74.27,
2012,G,CLEAR CREEK,2021310004,742,265,1007,687,68.22,
2012,G,CLEAR CREEK,2021310005,718,255,973,659,67.73,
2012,G,CLEAR CREEK,2021310006,423,185,608,379,62.34,
2012,G,CLEAR CREEK,2021310007,1053,267,1320,1000,75.76,
2012,G,CLEAR CREEK,2021310008,689,142,831,652,78.46,
2012,G,CLEAR CREEK,2021310009,969,228,1197,934,78.03,
2012,G,CONEJOS,3356211001,403,117,520,377,72.5,
2012,G,CONEJOS,3356211002,473,119,592,433,73.14,
2012,G,CONEJOS,3356211003,348,111,459,317,69.06,
2012,G,CONEJOS,3356211004,429,129,558,404,72.4,
2012,G,CONEJOS,3356211005,428,161,589,405,68.76,
2012,G,CONEJOS,3356211006,622,126,748,569,76.07,
2012,G,CONEJOS,3356211007,318,78,396,308,77.78,
2012,G,CONEJOS,3356211008,654,132,786,630,80.15,
2012,G,CONEJOS,3356211009,387,97,484,370,76.45,
2012,G,CONEJOS,3356211010,327,112,439,312,71.07,
2012,G,COSTILLA,3356212001,207,39,246,181,73.58,
2012,G,COSTILLA,3356212002,260,38,298,230,77.18,
2012,G,COSTILLA,3356212003,151,21,172,137,79.65,
2012,G,COSTILLA,3356212004,303,68,371,271,73.05,
2012,G,COSTILLA,3356212005,139,72,211,119,56.4,
2012,G,COSTILLA,3356212006,91,47,138,90,65.22,
2012,G,COSTILLA,3356212007,614,157,771,548,71.08,
2012,G,COSTILLA,3356212008,358,152,510,324,63.53,
2012,G,CROWLEY,4356413001,343,132,475,320,67.37,
2012,G,CROWLEY,4356413002,266,96,362,266,73.48,
2012,G,CROWLEY,4356413003,242,91,333,212,63.66,
2012,G,CROWLEY,4356413004,257,96,353,244,69.12,
2012,G,CROWLEY,4356413005,267,95,362,243,67.13,
2012,G,CROWLEY,4356413006,247,88,335,243,72.54,
2012,G,CUSTER,3356014001,1402,345,1747,1317,75.39,
2012,G,CUSTER,3356014002,343,74,417,318,76.26,
2012,G,CUSTER,3356014003,1145,239,1384,1101,79.55,
2012,G,DELTA,3055415001,957,179,1136,939,82.66,
2012,G,DELTA,3055415002,609,169,778,564,72.49,
2012,G,DELTA,3055415003,532,257,789,488,61.85,
2012,G,DELTA,3055415004,853,315,1168,784,67.12,
2012,G,DELTA,3055415005,636,192,828,593,71.62,
2012,G,DELTA,3055415006,817,238,1055,785,74.41,
2012,G,DELTA,3055415007,838,193,1031,804,77.98,
2012,G,DELTA,3056115008,891,263,1154,837,72.53,
2012,G,DELTA,3056115009,1009,236,1245,864,69.4,
2012,G,DELTA,3056115010,910,250,1160,976,84.14,
2012,G,DELTA,3056115011,885,216,1101,846,76.84,
2012,G,DELTA,3056115012,629,202,831,610,73.41,
2012,G,DELTA,3056115013,817,160,977,788,80.66,
2012,G,DELTA,3056115014,985,177,1162,942,81.07,
2012,G,DELTA,3056115015,1097,218,1315,1063,80.84,
2012,G,DELTA,3056115016,887,228,1115,850,76.23,
2012,G,DELTA,3056115017,816,210,1026,760,74.07,
2012,G,DELTA,3056115018,948,241,1189,911,76.62,
2012,G,DELTA,3056115019,689,214,903,639,70.76,
2012,G,DELTA,3056115020,866,183,1049,823,78.46,
2012,G,DENVER,1160116112,989,317,1306,932,71.36,
2012,G,DENVER,1160116113,921,188,1109,880,79.35,
2012,G,DENVER,1160116114,974,313,1287,940,73.04,
2012,G,DENVER,1160116120,1358,860,2218,1226,55.28,
2012,G,DENVER,1160116122,1037,320,1357,983,72.44,
2012,G,DENVER,1160116123,1119,334,1453,1066,73.37,
2012,G,DENVER,1160116124,954,351,1305,908,69.58,
2012,G,DENVER,1160116125,1026,512,1538,985,64.04,
2012,G,DENVER,1160116126,1163,624,1787,1056,59.09,
2012,G,DENVER,1160116127,1090,506,1596,1018,63.78,
2012,G,DENVER,1160116128,828,266,1094,783,71.57,
2012,G,DENVER,1160116129,781,155,936,748,79.91,
2012,G,DENVER,1160116130,977,401,1378,931,67.56,
2012,G,DENVER,1160116131,939,303,1242,896,72.14,
2012,G,DENVER,1160116132,1131,596,1727,1078,62.42,
2012,G,DENVER,1310216204,1306,1218,2524,1183,46.87,
2012,G,DENVER,1310216205,1136,998,2134,1050,49.2,
2012,G,DENVER,1310216206,1373,1301,2674,1232,46.07,
2012,G,DENVER,1310216207,1176,790,1966,1103,56.1,
2012,G,DENVER,1310216208,1224,1004,2228,1149,51.57,
2012,G,DENVER,1310216209,1042,617,1659,990,59.67,
2012,G,DENVER,1310216210,1166,695,1861,1097,58.95,
2012,G,DENVER,1310216211,958,683,1641,905,55.15,
2012,G,DENVER,1310516530,121,131,252,113,44.84,
2012,G,DENVER,1310616605,774,244,1018,749,73.58,
2012,G,DENVER,1310616606,886,312,1198,840,70.12,
2012,G,DENVER,1310616607,662,179,841,639,75.98,
2012,G,DENVER,1310616609,277,59,336,263,78.27,
2012,G,DENVER,1310616610,373,98,471,357,75.8,
2012,G,DENVER,1310616611,671,318,989,613,61.98,
2012,G,DENVER,1310616612,958,347,1305,911,69.81,
2012,G,DENVER,1310616613,912,417,1329,849,63.88,
2012,G,DENVER,1310616614,656,209,865,618,71.45,
2012,G,DENVER,1310616615,831,144,975,809,82.97,
2012,G,DENVER,1310616617,868,329,1197,837,69.92,
2012,G,DENVER,1310616618,836,322,1158,795,68.65,
2012,G,DENVER,1310616619,841,324,1165,811,69.61,
2012,G,DENVER,1310616622,1081,210,1291,1032,79.94,
2012,G,DENVER,1310616623,1204,233,1437,1161,80.79,
2012,G,DENVER,1310616624,1210,280,1490,1161,77.92,
2012,G,DENVER,1310616625,758,174,932,708,75.97,
2012,G,DENVER,1310616626,796,376,1172,757,64.59,
2012,G,DENVER,1310616627,1117,247,1364,1067,78.23,
2012,G,DENVER,1310616628,1227,430,1657,1150,69.4,
2012,G,DENVER,1310616629,731,165,896,704,78.57,
2012,G,DENVER,1310616630,720,167,887,698,78.69,
2012,G,DENVER,1310616631,1614,953,2567,1469,57.23,
2012,G,DENVER,1310616641,1205,412,1617,1105,68.34,
2012,G,DENVER,1310616642,1014,177,1191,957,80.35,
2012,G,DENVER,1310616643,1280,456,1736,1189,68.49,
2012,G,DENVER,1310616644,1448,345,1793,1388,77.41,
2012,G,DENVER,1310616645,499,128,627,463,73.84,
2012,G,DENVER,1310616646,1308,894,2202,1166,52.95,
2012,G,DENVER,1310616647,1020,347,1367,930,68.03,
2012,G,DENVER,1310616648,1040,341,1381,964,69.8,
2012,G,DENVER,1310616649,1550,1152,2702,1343,49.7,
2012,G,DENVER,1310616650,974,405,1379,892,64.68,
2012,G,DENVER,1310616651,1506,1354,2860,1350,47.2,
2012,G,DENVER,1310816841,1092,817,1909,997,52.23,
2012,G,DENVER,1310816842,879,459,1338,818,61.14,
2012,G,DENVER,1310816843,972,651,1623,911,56.13,
2012,G,DENVER,1310816844,1177,825,2002,1089,54.4,
2012,G,DENVER,1310816845,1000,613,1613,941,58.34,
2012,G,DENVER,1310816846,921,574,1495,869,58.13,
2012,G,DENVER,1310816848,1093,638,1731,1042,60.2,
2012,G,DENVER,1310816849,1195,653,1848,1111,60.12,
2012,G,DENVER,1310816850,856,316,1172,833,71.08,
2012,G,DENVER,1310816851,1145,600,1745,1083,62.06,
2012,G,DENVER,1310816852,879,327,1206,829,68.74,
2012,G,DENVER,1310816853,866,180,1046,827,79.06,
2012,G,DENVER,1310816854,949,397,1346,916,68.05,
2012,G,DENVER,1310816855,1321,955,2276,1206,52.99,
2012,G,DENVER,1310916901,1172,1034,2206,1039,47.1,
2012,G,DENVER,1310916903,1166,328,1494,1116,74.7,
2012,G,DENVER,1310916904,1040,247,1287,971,75.45,
2012,G,DENVER,1310916905,269,61,330,262,79.39,
2012,G,DENVER,1310916906,970,287,1257,925,73.59,
2012,G,DENVER,1310916908,1140,365,1505,1048,69.63,
2012,G,DENVER,1310916909,1183,287,1470,1111,75.58,
2012,G,DENVER,1310916910,1349,597,1946,1285,66.03,
2012,G,DENVER,1310916911,1482,964,2446,1334,54.54,
2012,G,DENVER,1310916912,1166,435,1601,1068,66.71,
2012,G,DENVER,1310916916,1347,306,1653,1260,76.23,
2012,G,DENVER,1310916917,1300,325,1625,1246,76.68,
2012,G,DENVER,1310916918,1231,262,1493,1172,78.5,
2012,G,DENVER,1310916919,1225,266,1491,1166,78.2,
2012,G,DENVER,1310916920,1134,314,1448,1083,74.79,
2012,G,DENVER,1310916921,1524,1210,2734,1370,50.11,
2012,G,DENVER,1310916922,1520,966,2486,1381,55.55,
2012,G,DENVER,1310916923,1386,793,2179,1256,57.64,
2012,G,DENVER,1310916924,1064,1240,2304,859,37.28,
2012,G,DENVER,1310916927,889,246,1135,848,74.71,
2012,G,DENVER,1310916928,798,157,955,778,81.47,
2012,G,DENVER,1310916929,842,388,1230,779,63.33,
2012,G,DENVER,1310916930,822,315,1137,769,67.63,
2012,G,DENVER,1310916931,774,125,899,737,81.98,
2012,G,DENVER,1310916932,996,363,1359,910,66.96,
2012,G,DENVER,1310916933,698,150,848,688,81.13,
2012,G,DENVER,1310916934,782,362,1144,724,63.29,
2012,G,DENVER,1310916935,1319,739,2058,1187,57.68,
2012,G,DENVER,1310916936,1008,724,1732,961,55.48,
2012,G,DENVER,1310916937,736,168,904,716,79.2,
2012,G,DENVER,1310916938,826,446,1272,760,59.75,
2012,G,DENVER,1320116103,1086,406,1492,963,64.54,
2012,G,DENVER,1320116104,865,491,1356,750,55.31,
2012,G,DENVER,1320116105,1155,411,1566,1062,67.82,
2012,G,DENVER,1320116106,1152,506,1658,1035,62.42,
2012,G,DENVER,1320116107,1301,489,1790,1156,64.58,
2012,G,DENVER,1320116108,1322,467,1789,1227,68.59,
2012,G,DENVER,1320116109,771,348,1119,644,57.55,
2012,G,DENVER,1320116110,1164,319,1483,1066,71.88,
2012,G,DENVER,1320116111,1214,440,1654,1113,67.29,
2012,G,DENVER,1320116115,394,72,466,389,83.48,
2012,G,DENVER,1320116116,1054,245,1299,1000,76.98,
2012,G,DENVER,1320116117,992,230,1222,942,77.09,
2012,G,DENVER,1320116118,1138,718,1856,1006,54.2,
2012,G,DENVER,1320116119,997,636,1633,894,54.75,
2012,G,DENVER,1320116121,1001,271,1272,945,74.29,
2012,G,DENVER,1320216212,1083,500,1583,1028,64.94,
2012,G,DENVER,1320216213,850,415,1265,791,62.53,
2012,G,DENVER,1320216214,924,449,1373,867,63.15,
2012,G,DENVER,1320216215,1212,685,1897,1133,59.73,
2012,G,DENVER,1320216216,927,559,1486,878,59.08,
2012,G,DENVER,1320216217,1104,469,1573,1047,66.56,
2012,G,DENVER,1320216218,1655,972,2627,1571,59.8,
2012,G,DENVER,1320216219,1620,998,2618,1541,58.86,
2012,G,DENVER,1320216220,915,409,1324,841,63.52,
2012,G,DENVER,1320216221,1454,800,2254,1368,60.69,
2012,G,DENVER,1320216222,914,381,1295,859,66.33,
2012,G,DENVER,1320216223,780,291,1071,741,69.19,
2012,G,DENVER,1320216224,833,348,1181,789,66.81,
2012,G,DENVER,1320216225,774,330,1104,738,66.85,
2012,G,DENVER,1320216226,767,300,1067,734,68.79,
2012,G,DENVER,1320216227,850,370,1220,785,64.34,
2012,G,DENVER,1320216228,596,155,751,572,76.17,
2012,G,DENVER,1320216229,725,227,952,695,73,
2012,G,DENVER,1320216230,777,207,984,763,77.54,
2012,G,DENVER,1320216231,811,283,1094,755,69.01,
2012,G,DENVER,1320216232,714,309,1023,631,61.68,
2012,G,DENVER,1320216233,1410,524,1934,1330,68.77,
2012,G,DENVER,1320216234,1405,509,1914,1367,71.42,
2012,G,DENVER,1320216235,1316,409,1725,1244,72.12,
2012,G,DENVER,1320216236,951,370,1321,893,67.6,
2012,G,DENVER,1320216237,1519,1740,3259,1320,40.5,
2012,G,DENVER,1320216238,1438,664,2102,1299,61.8,
2012,G,DENVER,1320216239,1140,499,1639,1087,66.32,
2012,G,DENVER,1320216240,772,371,1143,709,62.03,
2012,G,DENVER,1320216241,864,319,1183,833,70.41,
2012,G,DENVER,1320216242,876,381,1257,834,66.35,
2012,G,DENVER,1320216243,1003,456,1459,941,64.5,
2012,G,DENVER,1320216244,1030,616,1646,946,57.47,
2012,G,DENVER,1320216245,1047,369,1416,997,70.41,
2012,G,DENVER,1320216246,1047,334,1381,1005,72.77,
2012,G,DENVER,1320216247,591,243,834,546,65.47,
2012,G,DENVER,1320216248,859,191,1050,835,79.52,
2012,G,DENVER,1320216249,1252,143,1395,1223,87.67,
2012,G,DENVER,1320216250,1145,256,1401,1096,78.23,
2012,G,DENVER,1320516532,518,259,777,478,61.52,
2012,G,DENVER,1320516533,1053,449,1502,951,63.32,
2012,G,DENVER,1320516534,996,376,1372,883,64.36,
2012,G,DENVER,1320516535,1116,478,1594,1027,64.43,
2012,G,DENVER,1320516536,854,380,1234,732,59.32,
2012,G,DENVER,1320516537,953,399,1352,832,61.54,
2012,G,DENVER,1320516538,856,368,1224,760,62.09,
2012,G,DENVER,1320516539,792,331,1123,720,64.11,
2012,G,DENVER,1320616608,1194,315,1509,1142,75.68,
2012,G,DENVER,1320616616,1155,269,1424,1109,77.88,
2012,G,DENVER,1320616620,913,489,1402,821,58.56,
2012,G,DENVER,1320616621,861,413,1274,813,63.81,
2012,G,DENVER,1320616632,983,329,1312,918,69.97,
2012,G,DENVER,1320616633,1008,300,1308,980,74.92,
2012,G,DENVER,1320616634,782,170,952,740,77.73,
2012,G,DENVER,1320616635,942,161,1103,896,81.23,
2012,G,DENVER,1320616636,1086,339,1425,1027,72.07,
2012,G,DENVER,1320616637,1042,224,1266,1008,79.62,
2012,G,DENVER,1320616638,599,133,732,578,78.96,
2012,G,DENVER,1320616639,1021,254,1275,975,76.47,
2012,G,DENVER,1320616640,1280,354,1634,1216,74.42,
2012,G,DENVER,1320916902,1553,1051,2604,1382,53.07,
2012,G,DENVER,1320916907,1236,654,1890,1112,58.84,
2012,G,DENVER,1320916913,1042,352,1394,973,69.8,
2012,G,DENVER,1320916914,923,234,1157,881,76.15,
2012,G,DENVER,1320916915,982,293,1275,933,73.18,
2012,G,DENVER,1320916925,638,110,748,611,81.68,
2012,G,DENVER,1320916926,670,197,867,650,74.97,
2012,G,DENVER,1330516516,553,274,827,461,55.74,
2012,G,DENVER,1330516520,1437,2191,3628,836,23.04,
2012,G,DENVER,1330516521,870,456,1326,794,59.88,
2012,G,DENVER,1330616601,556,188,744,520,69.89,
2012,G,DENVER,1330616602,769,379,1148,721,62.8,
2012,G,DENVER,1330616603,762,435,1197,709,59.23,
2012,G,DENVER,1330616604,1293,938,2231,1104,49.48,
2012,G,DENVER,1330716701,985,485,1470,874,59.46,
2012,G,DENVER,1330716702,1604,125,1729,1545,89.36,
2012,G,DENVER,1330716703,590,62,652,552,84.66,
2012,G,DENVER,1330716704,716,283,999,660,66.07,
2012,G,DENVER,1330716705,900,253,1153,837,72.59,
2012,G,DENVER,1330716706,905,191,1096,873,79.65,
2012,G,DENVER,1330716707,804,117,921,785,85.23,
2012,G,DENVER,1330716708,635,63,698,611,87.54,
2012,G,DENVER,1330716709,727,274,1001,672,67.13,
2012,G,DENVER,1330716710,825,206,1031,769,74.59,
2012,G,DENVER,1330716711,414,142,556,373,67.09,
2012,G,DENVER,1330716712,231,88,319,217,68.03,
2012,G,DENVER,1330716713,818,114,932,781,83.8,
2012,G,DENVER,1330716714,935,531,1466,817,55.73,
2012,G,DENVER,1330716715,860,382,1242,765,61.59,
2012,G,DENVER,1330716716,692,395,1087,579,53.27,
2012,G,DENVER,1330716717,831,378,1209,674,55.75,
2012,G,DENVER,1330716718,874,392,1266,745,58.85,
2012,G,DENVER,1330716719,794,324,1118,710,63.51,
2012,G,DENVER,1330716720,863,448,1311,730,55.68,
2012,G,DENVER,1330716721,775,261,1036,720,69.5,
2012,G,DENVER,1330716722,823,349,1172,743,63.4,
2012,G,DENVER,1330716723,788,303,1091,686,62.88,
2012,G,DENVER,1330716724,800,323,1123,741,65.98,
2012,G,DENVER,1330716725,825,396,1221,699,57.25,
2012,G,DENVER,1330716726,812,396,1208,738,61.09,
2012,G,DENVER,1330716727,918,239,1157,816,70.53,
2012,G,DENVER,1330716728,917,596,1513,843,55.72,
2012,G,DENVER,1330716729,816,234,1050,745,70.95,
2012,G,DENVER,1330716730,966,257,1223,886,72.44,
2012,G,DENVER,1330716731,1046,180,1226,979,79.85,
2012,G,DENVER,1330716732,789,213,1002,738,73.65,
2012,G,DENVER,1330716733,713,648,1361,595,43.72,
2012,G,DENVER,1330716734,1007,465,1472,901,61.21,
2012,G,DENVER,1330716735,839,375,1214,765,63.01,
2012,G,DENVER,1330716736,726,288,1014,667,65.78,
2012,G,DENVER,1330716737,816,360,1176,736,62.59,
2012,G,DENVER,1330716738,854,259,1113,772,69.36,
2012,G,DENVER,1330716739,789,306,1095,702,64.11,
2012,G,DENVER,1330716740,838,326,1164,769,66.07,
2012,G,DENVER,1330716741,829,418,1247,762,61.11,
2012,G,DENVER,1330716742,628,192,820,557,67.93,
2012,G,DENVER,1330816801,716,414,1130,619,54.78,
2012,G,DENVER,1330816802,815,396,1211,715,59.04,
2012,G,DENVER,1330816803,680,330,1010,599,59.31,
2012,G,DENVER,1330816804,699,336,1035,628,60.68,
2012,G,DENVER,1330816805,738,350,1088,634,58.27,
2012,G,DENVER,1330816806,1198,462,1660,1065,64.16,
2012,G,DENVER,1330816807,1084,473,1557,964,61.91,
2012,G,DENVER,1330816808,1134,580,1714,965,56.3,
2012,G,DENVER,1330816810,1051,536,1587,946,59.61,
2012,G,DENVER,1330816811,925,579,1504,825,54.85,
2012,G,DENVER,1330816812,954,541,1495,836,55.92,
2012,G,DENVER,1330816813,876,524,1400,777,55.5,
2012,G,DENVER,1330816814,776,383,1159,702,60.57,
2012,G,DENVER,1330816815,767,349,1116,686,61.47,
2012,G,DENVER,1330816816,757,325,1082,688,63.59,
2012,G,DENVER,1330816817,790,319,1109,715,64.47,
2012,G,DENVER,1330816818,687,241,928,622,67.03,
2012,G,DENVER,1330816819,702,254,956,647,67.68,
2012,G,DENVER,1330816820,942,254,1196,870,72.74,
2012,G,DENVER,1330816821,859,276,1135,789,69.52,
2012,G,DENVER,1330816822,919,339,1258,842,66.93,
2012,G,DENVER,1330816823,928,226,1154,891,77.21,
2012,G,DENVER,1330816824,960,266,1226,894,72.92,
2012,G,DENVER,1330816825,919,243,1162,890,76.59,
2012,G,DENVER,1330816826,981,740,1721,851,49.45,
2012,G,DENVER,1330816827,957,482,1439,903,62.75,
2012,G,DENVER,1330816828,1281,1005,2286,1129,49.39,
2012,G,DENVER,1330816829,1173,467,1640,1054,64.27,
2012,G,DENVER,1330816830,1000,471,1471,945,64.24,
2012,G,DENVER,1330816831,933,161,1094,900,82.27,
2012,G,DENVER,1330816832,938,214,1152,907,78.73,
2012,G,DENVER,1330816833,945,328,1273,923,72.51,
2012,G,DENVER,1330816834,912,288,1200,853,71.08,
2012,G,DENVER,1330816835,984,236,1220,937,76.8,
2012,G,DENVER,1330816836,1296,636,1932,1132,58.59,
2012,G,DENVER,1330816837,983,584,1567,898,57.31,
2012,G,DENVER,1330816838,973,582,1555,834,53.63,
2012,G,DENVER,1330816839,491,103,594,481,80.98,
2012,G,DENVER,1330816840,475,88,563,446,79.22,
2012,G,DENVER,1330816847,540,252,792,519,65.53,
2012,G,DENVER,1340116101,1019,643,1662,870,52.35,
2012,G,DENVER,1340116102,1108,592,1700,913,53.71,
2012,G,DENVER,1340216201,1133,868,2001,1038,51.87,
2012,G,DENVER,1340216202,1214,1118,2332,1094,46.91,
2012,G,DENVER,1340216203,883,567,1450,758,52.28,
2012,G,DENVER,1340416401,1053,356,1409,986,69.98,
2012,G,DENVER,1340416402,1276,742,2018,1152,57.09,
2012,G,DENVER,1340416403,944,337,1281,860,67.14,
2012,G,DENVER,1340416404,1132,391,1523,1058,69.47,
2012,G,DENVER,1340416405,1099,355,1454,1023,70.36,
2012,G,DENVER,1340416406,838,360,1198,793,66.19,
2012,G,DENVER,1340416407,1158,423,1581,1102,69.7,
2012,G,DENVER,1340416408,1175,401,1576,1095,69.48,
2012,G,DENVER,1340416409,1106,345,1451,1051,72.43,
2012,G,DENVER,1340416410,881,346,1227,844,68.79,
2012,G,DENVER,1340416411,897,391,1288,850,65.99,
2012,G,DENVER,1340416412,1247,468,1715,1186,69.15,
2012,G,DENVER,1340416413,1253,355,1608,1199,74.56,
2012,G,DENVER,1340416414,1178,412,1590,1123,70.63,
2012,G,DENVER,1340416415,1322,467,1789,1259,70.37,
2012,G,DENVER,1340416416,1163,456,1619,1093,67.51,
2012,G,DENVER,1340416417,923,400,1323,885,66.89,
2012,G,DENVER,1340416418,1303,574,1877,1202,64.04,
2012,G,DENVER,1340416419,1184,364,1548,1139,73.58,
2012,G,DENVER,1340416420,1182,465,1647,1093,66.36,
2012,G,DENVER,1340416421,1280,516,1796,1193,66.43,
2012,G,DENVER,1340416422,1162,456,1618,1103,68.17,
2012,G,DENVER,1340416423,945,552,1497,821,54.84,
2012,G,DENVER,1340416424,925,466,1391,804,57.8,
2012,G,DENVER,1340416425,958,553,1511,827,54.73,
2012,G,DENVER,1340416426,1198,820,2018,1040,51.54,
2012,G,DENVER,1340416427,397,395,792,317,40.03,
2012,G,DENVER,1340416428,1072,608,1680,935,55.65,
2012,G,DENVER,1340416429,925,448,1373,822,59.87,
2012,G,DENVER,1340416430,841,440,1281,762,59.48,
2012,G,DENVER,1340416431,1075,392,1467,993,67.69,
2012,G,DENVER,1340416432,994,442,1436,885,61.63,
2012,G,DENVER,1340416433,1056,465,1521,939,61.74,
2012,G,DENVER,1340416434,1006,472,1478,880,59.54,
2012,G,DENVER,1340416435,782,401,1183,681,57.57,
2012,G,DENVER,1340416436,882,540,1422,744,52.32,
2012,G,DENVER,1340516501,976,336,1312,896,68.29,
2012,G,DENVER,1340516502,634,411,1045,580,55.5,
2012,G,DENVER,1340516503,919,531,1450,791,54.55,
2012,G,DENVER,1340516504,823,383,1206,736,61.03,
2012,G,DENVER,1340516505,867,403,1270,758,59.69,
2012,G,DENVER,1340516506,912,301,1213,829,68.34,
2012,G,DENVER,1340516507,890,459,1349,784,58.12,
2012,G,DENVER,1340516508,727,280,1007,693,68.82,
2012,G,DENVER,1340516509,679,349,1028,619,60.21,
2012,G,DENVER,1340516510,513,356,869,468,53.86,
2012,G,DENVER,1340516511,786,340,1126,737,65.45,
2012,G,DENVER,1340516512,932,570,1502,901,59.99,
2012,G,DENVER,1340516513,886,337,1223,829,67.78,
2012,G,DENVER,1340516514,974,519,1493,919,61.55,
2012,G,DENVER,1340516515,1216,831,2047,1099,53.69,
2012,G,DENVER,1340516517,678,328,1006,628,62.43,
2012,G,DENVER,1340516518,768,397,1165,685,58.8,
2012,G,DENVER,1340516519,685,531,1216,595,48.93,
2012,G,DENVER,1340516522,1223,650,1873,1151,61.45,
2012,G,DENVER,1340516523,1100,729,1829,1018,55.66,
2012,G,DENVER,1340516524,1058,640,1698,998,58.78,
2012,G,DENVER,1340516525,911,871,1782,816,45.79,
2012,G,DENVER,1340516526,552,479,1031,448,43.45,
2012,G,DENVER,1340516527,1437,1107,2544,1218,47.88,
2012,G,DENVER,1340516528,1691,1122,2813,1509,53.64,
2012,G,DENVER,1340516529,1259,588,1847,1156,62.59,
2012,G,DENVER,1340516531,1224,675,1899,1019,53.66,
2012,G,DENVER,1340816809,658,317,975,547,56.1,
2012,G,DOLORES,3065817001,199,70,269,183,68.03,
2012,G,DOLORES,3065817002,275,63,338,259,76.63,
2012,G,DOLORES,3065817003,318,68,386,301,77.98,
2012,G,DOLORES,3065817004,523,155,678,487,71.83,
2012,G,DOUGLAS,4043918106,243,53,296,223,75.34,
2012,G,DOUGLAS,4043918107,681,99,780,632,81.03,
2012,G,DOUGLAS,4043918306,908,121,1029,872,84.74,
2012,G,DOUGLAS,4043918317,683,95,778,633,81.36,
2012,G,DOUGLAS,4043918332,1576,227,1803,1518,84.19,
2012,G,DOUGLAS,4043918345,983,163,1146,935,81.59,
2012,G,DOUGLAS,4043918346,906,113,1019,870,85.38,
2012,G,DOUGLAS,4043918401,1147,167,1314,1101,83.79,
2012,G,DOUGLAS,4043918402,502,60,562,478,85.05,
2012,G,DOUGLAS,4043918403,204,50,254,194,76.38,
2012,G,DOUGLAS,4043918404,1347,187,1534,1268,82.66,
2012,G,DOUGLAS,4043918405,1296,166,1462,1202,82.22,
2012,G,DOUGLAS,4043918406,710,142,852,662,77.7,
2012,G,DOUGLAS,4043918508,1525,206,1731,1442,83.3,
2012,G,DOUGLAS,4043918511,955,167,1122,910,81.11,
2012,G,DOUGLAS,4043918512,1135,176,1311,1093,83.37,
2012,G,DOUGLAS,4044418302,1277,370,1647,1211,73.53,
2012,G,DOUGLAS,4044418303,2056,678,2734,1896,69.35,
2012,G,DOUGLAS,4044418304,1118,580,1698,1013,59.66,
2012,G,DOUGLAS,4044418309,1318,527,1845,1196,64.82,
2012,G,DOUGLAS,4044418315,1503,295,1798,1419,78.92,
2012,G,DOUGLAS,4044418316,1844,677,2521,1669,66.2,
2012,G,DOUGLAS,4044418318,1061,196,1257,1006,80.03,
2012,G,DOUGLAS,4044418319,947,220,1167,896,76.78,
2012,G,DOUGLAS,4044418320,994,234,1228,931,75.81,
2012,G,DOUGLAS,4044418321,1583,322,1905,1509,79.21,
2012,G,DOUGLAS,4044418322,1263,416,1679,1168,69.57,
2012,G,DOUGLAS,4044418323,923,200,1123,873,77.74,
2012,G,DOUGLAS,4044418324,1285,313,1598,1236,77.35,
2012,G,DOUGLAS,4044418325,902,197,1099,842,76.62,
2012,G,DOUGLAS,4044418326,1761,316,2077,1669,80.36,
2012,G,DOUGLAS,4044418327,1341,201,1542,1256,81.45,
2012,G,DOUGLAS,4044418328,1693,480,2173,1590,73.17,
2012,G,DOUGLAS,4044418329,1712,323,2035,1645,80.84,
2012,G,DOUGLAS,4044418330,1063,149,1212,1023,84.41,
2012,G,DOUGLAS,4044418331,1291,296,1587,1257,79.21,
2012,G,DOUGLAS,4044418334,1556,371,1927,1460,75.77,
2012,G,DOUGLAS,4044518108,897,261,1158,831,71.76,
2012,G,DOUGLAS,4044518109,1358,296,1654,1296,78.36,
2012,G,DOUGLAS,4044518110,794,207,1001,757,75.62,
2012,G,DOUGLAS,4044518111,1964,476,2440,1872,76.72,
2012,G,DOUGLAS,4044518112,1681,353,2034,1587,78.02,
2012,G,DOUGLAS,4044518113,1554,258,1812,1454,80.24,
2012,G,DOUGLAS,4044518114,2168,377,2545,2043,80.28,
2012,G,DOUGLAS,4044518261,1395,188,1583,1312,82.88,
2012,G,DOUGLAS,4044518262,1317,323,1640,1246,75.98,
2012,G,DOUGLAS,4044518263,1786,236,2022,1705,84.32,
2012,G,DOUGLAS,4044518264,1614,502,2116,1451,68.57,
2012,G,DOUGLAS,4044518333,1017,125,1142,952,83.36,
2012,G,DOUGLAS,4044518335,631,96,727,598,82.26,
2012,G,DOUGLAS,4044518336,1212,175,1387,1152,83.06,
2012,G,DOUGLAS,4044518337,1029,302,1331,931,69.95,
2012,G,DOUGLAS,4044518338,1611,323,1934,1515,78.34,
2012,G,DOUGLAS,4044518339,1724,398,2122,1644,77.47,
2012,G,DOUGLAS,4044518340,1344,225,1569,1278,81.45,
2012,G,DOUGLAS,4044518341,1198,200,1398,1138,81.4,
2012,G,DOUGLAS,4044518342,1304,170,1474,1240,84.12,
2012,G,DOUGLAS,4044518343,1168,229,1397,1078,77.17,
2012,G,DOUGLAS,4044518344,1139,124,1263,1081,85.59,
2012,G,DOUGLAS,4044518347,662,191,853,607,71.16,
2012,G,DOUGLAS,4044518348,1565,361,1926,1461,75.86,
2012,G,DOUGLAS,4044518501,1742,580,2322,1586,68.3,
2012,G,DOUGLAS,4044518502,1180,281,1461,1107,75.77,
2012,G,DOUGLAS,4044518503,1323,403,1726,1199,69.47,
2012,G,DOUGLAS,4044518504,1409,345,1754,1321,75.31,
2012,G,DOUGLAS,4044518505,1032,276,1308,969,74.08,
2012,G,DOUGLAS,4044518506,1891,651,2542,1774,69.79,
2012,G,DOUGLAS,4044518507,1377,319,1696,1310,77.24,
2012,G,DOUGLAS,4044518509,976,134,1110,925,83.33,
2012,G,DOUGLAS,4044518510,893,140,1033,830,80.35,
2012,G,DOUGLAS,4303918101,747,123,870,713,81.95,
2012,G,DOUGLAS,4303918102,1970,396,2366,1892,79.97,
2012,G,DOUGLAS,4303918103,1854,497,2351,1774,75.46,
2012,G,DOUGLAS,4303918104,714,115,829,680,82.03,
2012,G,DOUGLAS,4303918105,1758,212,1970,1710,86.8,
2012,G,DOUGLAS,4304418206,927,192,1119,891,79.62,
2012,G,DOUGLAS,4304418207,1068,370,1438,1004,69.82,
2012,G,DOUGLAS,4304418208,1085,706,1791,939,52.43,
2012,G,DOUGLAS,4304418232,1007,183,1190,959,80.59,
2012,G,DOUGLAS,4304418233,1307,197,1504,1254,83.38,
2012,G,DOUGLAS,4304418245,1789,361,2150,1710,79.53,
2012,G,DOUGLAS,4304418257,2237,336,2573,1710,66.46,
2012,G,DOUGLAS,4304418301,1314,556,1870,1194,63.85,
2012,G,DOUGLAS,4304418307,1265,273,1538,1166,75.81,
2012,G,DOUGLAS,4304418308,1286,254,1540,1226,79.61,
2012,G,DOUGLAS,4304418311,1004,345,1349,919,68.12,
2012,G,DOUGLAS,4304418312,1347,192,1539,1271,82.59,
2012,G,DOUGLAS,4304418313,976,128,1104,904,81.88,
2012,G,DOUGLAS,4304418314,921,156,1077,871,80.87,
2012,G,DOUGLAS,4304518258,1406,213,1619,1338,82.64,
2012,G,DOUGLAS,4304518259,1241,179,1420,1197,84.3,
2012,G,DOUGLAS,4304518260,2000,265,2265,1880,83,
2012,G,DOUGLAS,6043918305,632,72,704,621,88.21,
2012,G,DOUGLAS,6043918310,659,92,751,627,83.49,
2012,G,DOUGLAS,6303918243,1502,276,1778,1439,80.93,
2012,G,DOUGLAS,6303918247,1301,136,1437,1225,85.25,
2012,G,DOUGLAS,6303918249,1210,255,1465,1161,79.25,
2012,G,DOUGLAS,6303918250,1045,283,1328,999,75.23,
2012,G,DOUGLAS,6303918251,904,229,1133,848,74.85,
2012,G,DOUGLAS,6303918252,1343,353,1696,1269,74.82,
2012,G,DOUGLAS,6303918253,781,165,946,764,80.76,
2012,G,DOUGLAS,6303918254,1748,300,2048,1647,80.42,
2012,G,DOUGLAS,6303918255,983,208,1191,938,78.76,
2012,G,DOUGLAS,6303918256,808,125,933,783,83.92,
2012,G,DOUGLAS,6304318201,1079,213,1292,1023,79.18,
2012,G,DOUGLAS,6304318202,1291,333,1624,1236,76.11,
2012,G,DOUGLAS,6304318203,1160,255,1415,1109,78.37,
2012,G,DOUGLAS,6304318204,1051,485,1536,944,61.46,
2012,G,DOUGLAS,6304318205,1535,669,2204,1395,63.29,
2012,G,DOUGLAS,6304318209,1326,237,1563,1265,80.93,
2012,G,DOUGLAS,6304318210,1868,502,2370,1730,73,
2012,G,DOUGLAS,6304318211,991,225,1216,946,77.8,
2012,G,DOUGLAS,6304318212,1257,217,1474,1191,80.8,
2012,G,DOUGLAS,6304318213,1054,109,1163,1022,87.88,
2012,G,DOUGLAS,6304318214,670,106,776,640,82.47,
2012,G,DOUGLAS,6304318215,1001,204,1205,949,78.76,
2012,G,DOUGLAS,6304318216,804,117,921,773,83.93,
2012,G,DOUGLAS,6304318217,996,231,1227,948,77.26,
2012,G,DOUGLAS,6304318218,1022,92,1114,961,86.27,
2012,G,DOUGLAS,6304318219,897,202,1099,850,77.34,
2012,G,DOUGLAS,6304318220,937,198,1135,894,78.77,
2012,G,DOUGLAS,6304318221,827,132,959,793,82.69,
2012,G,DOUGLAS,6304318222,1251,299,1550,1156,74.58,
2012,G,DOUGLAS,6304318223,1502,338,1840,1418,77.07,
2012,G,DOUGLAS,6304318224,1413,223,1636,1338,81.78,
2012,G,DOUGLAS,6304318225,1682,400,2082,1584,76.08,
2012,G,DOUGLAS,6304318226,1128,211,1339,1078,80.51,
2012,G,DOUGLAS,6304318227,1412,197,1609,1349,83.84,
2012,G,DOUGLAS,6304318228,898,141,1039,850,81.81,
2012,G,DOUGLAS,6304318229,1048,216,1264,992,78.48,
2012,G,DOUGLAS,6304318230,975,192,1167,925,79.26,
2012,G,DOUGLAS,6304318231,1288,290,1578,1223,77.5,
2012,G,DOUGLAS,6304318234,901,133,1034,863,83.46,
2012,G,DOUGLAS,6304318235,1492,290,1782,1420,79.69,
2012,G,DOUGLAS,6304318236,1682,295,1977,1591,80.48,
2012,G,DOUGLAS,6304318237,1231,165,1396,1176,84.24,
2012,G,DOUGLAS,6304318238,1219,199,1418,1166,82.23,
2012,G,DOUGLAS,6304318239,1456,254,1710,1390,81.29,
2012,G,DOUGLAS,6304318240,1072,393,1465,976,66.62,
2012,G,DOUGLAS,6304318241,1157,275,1432,1076,75.14,
2012,G,DOUGLAS,6304318242,918,256,1174,874,74.45,
2012,G,DOUGLAS,6304318244,1273,222,1495,1186,79.33,
2012,G,DOUGLAS,6304318246,1376,276,1652,1317,79.72,
2012,G,DOUGLAS,6304318248,910,179,1089,867,79.61,
2012,G,EAGLE,2052619001,165,78,243,156,64.2,
2012,G,EAGLE,2052619002,696,516,1212,685,56.52,
2012,G,EAGLE,2052619003,636,290,926,598,64.58,
2012,G,EAGLE,2052619011,561,316,877,482,54.96,
2012,G,EAGLE,2052619012,1046,628,1674,947,56.57,
2012,G,EAGLE,2052619013,734,335,1069,672,62.86,
2012,G,EAGLE,2052619014,582,338,920,582,63.26,
2012,G,EAGLE,2052619015,990,627,1617,856,52.94,
2012,G,EAGLE,2052619019,1111,460,1571,1022,65.05,
2012,G,EAGLE,3052619004,822,203,1025,790,77.07,
2012,G,EAGLE,3052619005,1467,484,1951,1381,70.78,
2012,G,EAGLE,3052619006,694,243,937,629,67.13,
2012,G,EAGLE,3052619007,1144,342,1486,1069,71.94,
2012,G,EAGLE,3052619008,448,160,608,415,68.26,
2012,G,EAGLE,3052619009,715,242,957,665,69.49,
2012,G,EAGLE,3052619010,149,36,185,142,76.76,
2012,G,EAGLE,3052619016,555,105,660,546,82.73,
2012,G,EAGLE,3052619017,747,340,1087,711,65.41,
2012,G,EAGLE,3052619018,723,268,991,656,66.2,
2012,G,EAGLE,3052619020,1207,247,1454,1149,79.02,
2012,G,EAGLE,3052619021,250,64,314,230,73.25,
2012,G,EAGLE,3052619022,1035,346,1381,899,65.1,
2012,G,EAGLE,3052619023,830,314,1144,745,65.12,
2012,G,EAGLE,3052619024,1166,381,1547,1085,70.14,
2012,G,EAGLE,3052619025,1055,234,1289,987,76.57,
2012,G,EAGLE,3052619026,867,170,1037,801,77.24,
2012,G,EAGLE,3052619027,1408,295,1703,1343,78.86,
2012,G,EAGLE,3052619028,784,254,1038,745,71.77,
2012,G,EAGLE,3052619029,1172,425,1597,1082,67.75,
2012,G,EAGLE,3052619030,837,182,1019,774,75.96,
2012,G,EL PASO,5021821745,235,34,269,230,85.5,
2012,G,EL PASO,5021921452,1174,385,1559,1077,69.08,
2012,G,EL PASO,5021921500,308,79,387,294,75.97,
2012,G,EL PASO,5021921501,846,253,1099,813,73.98,
2012,G,EL PASO,5021921502,693,210,903,658,72.87,
2012,G,EL PASO,5021921521,870,353,1223,796,65.09,
2012,G,EL PASO,5021921522,1075,350,1425,1017,71.37,
2012,G,EL PASO,5021921523,940,255,1195,882,73.81,
2012,G,EL PASO,5021921524,1217,297,1514,1168,77.15,
2012,G,EL PASO,5021921554,113,35,148,106,71.62,
2012,G,EL PASO,5021921560,933,344,1277,870,68.13,
2012,G,EL PASO,5021921653,187,38,225,180,80,
2012,G,EL PASO,5021921828,388,134,522,387,74.14,
2012,G,EL PASO,5022021740,1609,437,2046,1558,76.15,
2012,G,EL PASO,5022121632,705,313,1018,601,59.04,
2012,G,EL PASO,5022121639,1944,808,2752,1732,62.94,
2012,G,EL PASO,5022121652,587,141,728,557,76.51,
2012,G,EL PASO,5022121801,849,366,1215,694,57.12,
2012,G,EL PASO,5022121802,2309,1097,3406,2025,59.45,
2012,G,EL PASO,5022121803,2123,873,2996,1832,61.15,
2012,G,EL PASO,5022121804,1991,797,2788,1807,64.81,
2012,G,EL PASO,5022121839,775,243,1018,684,67.19,
2012,G,EL PASO,5091421215,2138,553,2691,2050,76.18,
2012,G,EL PASO,5091421216,1997,502,2499,1890,75.63,
2012,G,EL PASO,5091421217,2012,472,2484,1907,76.77,
2012,G,EL PASO,5091421220,2435,491,2926,2284,78.06,
2012,G,EL PASO,5091421230,1982,394,2376,1895,79.76,
2012,G,EL PASO,5091421231,1974,521,2495,1878,75.27,
2012,G,EL PASO,5091421232,1671,443,2114,1579,74.69,
2012,G,EL PASO,5091421233,1491,323,1814,1405,77.45,
2012,G,EL PASO,5091421236,1636,597,2233,1536,68.79,
2012,G,EL PASO,5091421237,1520,497,2017,1422,70.5,
2012,G,EL PASO,5091421238,2041,659,2700,1945,72.04,
2012,G,EL PASO,5091521445,797,80,877,746,85.06,
2012,G,EL PASO,5091821107,1261,608,1869,1113,59.55,
2012,G,EL PASO,5091821108,1090,215,1305,1035,79.31,
2012,G,EL PASO,5091821109,196,55,251,200,79.68,
2012,G,EL PASO,5091921210,2054,451,2505,1980,79.04,
2012,G,EL PASO,5091921211,1967,477,2444,1894,77.5,
2012,G,EL PASO,5091921212,1526,280,1806,1488,82.39,
2012,G,EL PASO,5091921213,999,167,1166,985,84.48,
2012,G,EL PASO,5091921214,1495,274,1769,1438,81.29,
2012,G,EL PASO,5091921218,893,180,1073,882,82.2,
2012,G,EL PASO,5091921219,1122,223,1345,1096,81.49,
2012,G,EL PASO,5091921303,1779,429,2208,1705,77.22,
2012,G,EL PASO,5091921310,1969,437,2406,1884,78.3,
2012,G,EL PASO,5091921311,1886,340,2226,1828,82.12,
2012,G,EL PASO,5091921312,1917,319,2236,1818,81.31,
2012,G,EL PASO,5091921313,1067,208,1275,1035,81.18,
2012,G,EL PASO,5091921314,1769,377,2146,1686,78.56,
2012,G,EL PASO,5091921315,1387,291,1678,1358,80.93,
2012,G,EL PASO,5091921316,1974,331,2305,1892,82.08,
2012,G,EL PASO,5091921320,1644,304,1948,1623,83.32,
2012,G,EL PASO,5091921321,1188,206,1394,1132,81.21,
2012,G,EL PASO,5091921322,1177,216,1393,1122,80.55,
2012,G,EL PASO,5091921440,1813,346,2159,1744,80.78,
2012,G,EL PASO,5091921441,2214,535,2749,2079,75.63,
2012,G,EL PASO,5091921442,1827,393,2220,1700,76.58,
2012,G,EL PASO,5091921443,2040,643,2683,1924,71.71,
2012,G,EL PASO,5091921444,1946,555,2501,1809,72.33,
2012,G,EL PASO,5091921525,181,45,226,177,78.32,
2012,G,EL PASO,5092021101,1975,555,2530,1877,74.19,
2012,G,EL PASO,5092021102,1545,281,1826,1491,81.65,
2012,G,EL PASO,5092021103,1890,504,2394,1777,74.23,
2012,G,EL PASO,5092021104,2026,694,2720,1876,68.97,
2012,G,EL PASO,5092021105,1767,286,2053,1666,81.15,
2012,G,EL PASO,5092021106,2191,835,3026,1990,65.76,
2012,G,EL PASO,5092021200,427,504,931,314,33.73,
2012,G,EL PASO,5092021201,1689,237,1926,1610,83.59,
2012,G,EL PASO,5092021202,1787,361,2148,1715,79.84,
2012,G,EL PASO,5092021203,1748,341,2089,1684,80.61,
2012,G,EL PASO,5092021204,1970,349,2319,1910,82.36,
2012,G,EL PASO,5092021205,1856,503,2359,1763,74.74,
2012,G,EL PASO,5092021206,1708,484,2192,1616,73.72,
2012,G,EL PASO,5092021207,1794,451,2245,1705,75.95,
2012,G,EL PASO,5092021301,733,110,843,735,87.19,
2012,G,EL PASO,5092021302,1507,480,1987,1478,74.38,
2012,G,EL PASO,5092021741,420,73,493,393,79.72,
2012,G,EL PASO,5101421141,1840,767,2607,1724,66.13,
2012,G,EL PASO,5101421142,1852,738,2590,1711,66.06,
2012,G,EL PASO,5101421143,2227,693,2920,2135,73.12,
2012,G,EL PASO,5101421144,1229,347,1576,1179,74.81,
2012,G,EL PASO,5101421145,1587,501,2088,1509,72.27,
2012,G,EL PASO,5101421146,2076,731,2807,2006,71.46,
2012,G,EL PASO,5101421234,1635,455,2090,1564,74.83,
2012,G,EL PASO,5101421235,2077,634,2711,1949,71.89,
2012,G,EL PASO,5101421239,1703,568,2271,1613,71.03,
2012,G,EL PASO,5101421240,1967,684,2651,1811,68.31,
2012,G,EL PASO,5101421241,1135,381,1516,1046,69,
2012,G,EL PASO,5101421242,2077,765,2842,1924,67.7,
2012,G,EL PASO,5101421243,1473,634,2107,1365,64.78,
2012,G,EL PASO,5101521159,346,72,418,321,76.79,
2012,G,EL PASO,5101521401,2031,798,2829,1902,67.23,
2012,G,EL PASO,5101521402,2003,864,2867,1868,65.16,
2012,G,EL PASO,5101521403,2353,613,2966,2158,72.76,
2012,G,EL PASO,5101521404,1499,763,2262,1390,61.45,
2012,G,EL PASO,5101521405,1696,495,2191,1573,71.79,
2012,G,EL PASO,5101521406,1539,651,2190,1434,65.48,
2012,G,EL PASO,5101621120,1776,492,2268,1664,73.37,
2012,G,EL PASO,5101621121,1038,370,1408,932,66.19,
2012,G,EL PASO,5101621122,1446,768,2214,1207,54.52,
2012,G,EL PASO,5101621123,2120,711,2831,1910,67.47,
2012,G,EL PASO,5101621124,1602,458,2060,1478,71.75,
2012,G,EL PASO,5101621125,1994,563,2557,1884,73.68,
2012,G,EL PASO,5101621126,1607,549,2156,1439,66.74,
2012,G,EL PASO,5101621127,2056,472,2528,1911,75.59,
2012,G,EL PASO,5101621128,1813,261,2074,1732,83.51,
2012,G,EL PASO,5101621129,2056,945,3001,1787,59.55,
2012,G,EL PASO,5101621130,1942,564,2506,1819,72.59,
2012,G,EL PASO,5101621131,1658,415,2073,1554,74.96,
2012,G,EL PASO,5101621140,1795,506,2301,1672,72.66,
2012,G,EL PASO,5101621147,839,370,1209,778,64.35,
2012,G,EL PASO,5101621148,1443,476,1919,1335,69.57,
2012,G,EL PASO,5101621149,1870,495,2365,1777,75.14,
2012,G,EL PASO,5101621150,1840,356,2196,1773,80.74,
2012,G,EL PASO,5101621151,1580,405,1985,1515,76.32,
2012,G,EL PASO,5101621152,2221,956,3177,1997,62.86,
2012,G,EL PASO,5101621153,1864,494,2358,1785,75.7,
2012,G,EL PASO,5101621154,2257,1347,3604,2022,56.1,
2012,G,EL PASO,5101621157,1360,440,1800,1279,71.06,
2012,G,EL PASO,5101621160,1537,440,1977,1404,71.02,
2012,G,EL PASO,5101621175,1731,591,2322,1627,70.07,
2012,G,EL PASO,5101821171,1154,241,1395,1077,77.2,
2012,G,EL PASO,5101821174,1678,621,2299,1544,67.16,
2012,G,EL PASO,5101821181,174,53,227,158,69.6,
2012,G,EL PASO,5111721182,1257,520,1777,1085,61.06,
2012,G,EL PASO,5111721183,2131,930,3061,1810,59.13,
2012,G,EL PASO,5111721184,2358,1379,3737,1845,49.37,
2012,G,EL PASO,5111721190,1379,781,2160,1142,52.87,
2012,G,EL PASO,5111721193,923,490,1413,762,53.93,
2012,G,EL PASO,5111721194,818,411,1229,673,54.76,
2012,G,EL PASO,5111721610,872,504,1376,669,48.62,
2012,G,EL PASO,5111721611,2950,1653,4603,2239,48.64,
2012,G,EL PASO,5111721612,2353,1134,3487,1924,55.18,
2012,G,EL PASO,5111721613,2183,983,3166,1905,60.17,
2012,G,EL PASO,5111721620,2700,1496,4196,2222,52.96,
2012,G,EL PASO,5111721621,2532,1259,3791,2118,55.87,
2012,G,EL PASO,5111721622,2496,1278,3774,2106,55.8,
2012,G,EL PASO,5111721623,2225,1097,3322,1922,57.86,
2012,G,EL PASO,5111821110,1931,696,2627,1761,67.03,
2012,G,EL PASO,5111821111,1854,690,2544,1670,65.64,
2012,G,EL PASO,5111821112,1931,737,2668,1730,64.84,
2012,G,EL PASO,5111821113,1927,696,2623,1757,66.98,
2012,G,EL PASO,5111821114,2073,749,2822,1917,67.93,
2012,G,EL PASO,5111821170,1946,560,2506,1813,72.35,
2012,G,EL PASO,5111821172,2002,512,2514,1902,75.66,
2012,G,EL PASO,5111821173,2094,671,2765,1956,70.74,
2012,G,EL PASO,5111821176,2645,1729,4374,2154,49.25,
2012,G,EL PASO,5111821177,2714,1570,4284,2198,51.31,
2012,G,EL PASO,5111821178,2442,960,3402,2148,63.14,
2012,G,EL PASO,5111821179,2203,967,3170,1936,61.07,
2012,G,EL PASO,5111821180,2582,1377,3959,2227,56.25,
2012,G,EL PASO,5111821742,1081,375,1456,1006,69.09,
2012,G,EL PASO,5111821743,1164,395,1559,1102,70.69,
2012,G,EL PASO,5111821744,1096,211,1307,1019,77.96,
2012,G,EL PASO,5112021601,2056,1046,3102,1694,54.61,
2012,G,EL PASO,5121521158,1929,593,2522,1804,71.53,
2012,G,EL PASO,5121521161,1433,259,1692,1364,80.61,
2012,G,EL PASO,5121521162,1538,346,1884,1458,77.39,
2012,G,EL PASO,5121521191,1527,473,2000,1432,71.6,
2012,G,EL PASO,5121521192,1936,694,2630,1770,67.3,
2012,G,EL PASO,5121521195,2384,1429,3813,2061,54.05,
2012,G,EL PASO,5121521410,1966,595,2561,1866,72.86,
2012,G,EL PASO,5121521411,1783,582,2365,1671,70.66,
2012,G,EL PASO,5121521412,2103,792,2895,1958,67.63,
2012,G,EL PASO,5121521413,1973,762,2735,1851,67.68,
2012,G,EL PASO,5121521414,1496,537,2033,1404,69.06,
2012,G,EL PASO,5121521415,1505,632,2137,1369,64.06,
2012,G,EL PASO,5121521420,2106,783,2889,1903,65.87,
2012,G,EL PASO,5121521650,1081,463,1544,997,64.57,
2012,G,EL PASO,5121621155,1079,353,1432,1005,70.18,
2012,G,EL PASO,5121621156,849,213,1062,806,75.89,
2012,G,EL PASO,5121721631,379,217,596,312,52.35,
2012,G,EL PASO,5121821115,792,303,1095,732,66.85,
2012,G,EL PASO,5121821721,963,124,1087,928,85.37,
2012,G,EL PASO,5121821722,1496,265,1761,1439,81.71,
2012,G,EL PASO,5121821723,2085,686,2771,1921,69.33,
2012,G,EL PASO,5121821724,1713,757,2470,1566,63.4,
2012,G,EL PASO,5121921451,979,245,1224,917,74.92,
2012,G,EL PASO,5121921453,1258,342,1600,1195,74.69,
2012,G,EL PASO,5121921651,424,63,487,356,73.1,
2012,G,EL PASO,5122021602,1116,270,1386,1043,75.25,
2012,G,EL PASO,5122021603,989,457,1446,855,59.13,
2012,G,EL PASO,5122021604,2373,1410,3783,2073,54.8,
2012,G,EL PASO,5122021725,1484,376,1860,1370,73.66,
2012,G,EL PASO,5122021726,1134,146,1280,1078,84.22,
2012,G,EL PASO,5122021727,1401,220,1621,1338,82.54,
2012,G,EL PASO,5122021728,1760,349,2109,1694,80.32,
2012,G,EL PASO,5122021729,1876,371,2247,1794,79.84,
2012,G,EL PASO,5122021730,2023,514,2537,1863,73.43,
2012,G,EL PASO,5122121633,2267,843,3110,2107,67.75,
2012,G,EL PASO,5122121634,2067,709,2776,1909,68.77,
2012,G,EL PASO,5122121635,1362,453,1815,1275,70.25,
2012,G,EL PASO,5122121636,1520,610,2130,1400,65.73,
2012,G,EL PASO,5122121637,1948,679,2627,1737,66.12,
2012,G,EL PASO,5122121638,1799,609,2408,1666,69.19,
2012,G,EL PASO,5122121640,2147,822,2969,1997,67.26,
2012,G,EL PASO,5122121641,2351,736,3087,2125,68.84,
2012,G,EL PASO,5122121800,1802,1668,3470,902,25.99,
2012,G,ELBERT,4016420001,663,301,964,631,65.46,
2012,G,ELBERT,4016420002,419,114,533,391,73.36,
2012,G,ELBERT,4016420003,674,218,892,658,73.77,
2012,G,ELBERT,4016420004,472,115,587,460,78.36,
2012,G,ELBERT,4016420005,600,156,756,557,73.68,
2012,G,ELBERT,4016420006,382,74,456,344,75.44,
2012,G,ELBERT,4016420007,1213,286,1499,1168,77.92,
2012,G,ELBERT,4016420008,1050,310,1360,1045,76.84,
2012,G,ELBERT,4016420009,986,349,1335,948,71.01,
2012,G,ELBERT,4016420010,992,231,1223,945,77.27,
2012,G,ELBERT,4016420011,615,134,749,591,78.91,
2012,G,ELBERT,4016420012,1114,230,1344,1067,79.39,
2012,G,ELBERT,4016420013,916,275,1191,884,74.22,
2012,G,ELBERT,4016420014,903,246,1149,873,75.98,
2012,G,ELBERT,4016420015,748,189,937,722,77.05,
2012,G,ELBERT,4016420016,998,243,1241,980,78.97,
2012,G,ELBERT,4016420017,1222,297,1519,1201,79.07,
2012,G,ELBERT,4016420018,845,234,1079,809,74.98,
2012,G,FREMONT,5024722001,762,339,1101,729,66.21,
2012,G,FREMONT,5024722002,869,468,1337,846,63.28,
2012,G,FREMONT,5024722003,899,334,1233,870,70.56,
2012,G,FREMONT,5024722025,173,81,254,158,62.2,
2012,G,FREMONT,5024722026,390,134,524,384,73.28,
2012,G,FREMONT,5024722028,220,97,317,210,66.25,
2012,G,FREMONT,5026022004,741,450,1191,685,57.51,
2012,G,FREMONT,5026022005,554,364,918,507,55.23,
2012,G,FREMONT,5026022006,526,288,814,486,59.71,
2012,G,FREMONT,5026022007,1146,650,1796,1067,59.41,
2012,G,FREMONT,5026022008,652,307,959,612,63.82,
2012,G,FREMONT,5026022009,1064,347,1411,1011,71.65,
2012,G,FREMONT,5026022010,653,247,900,621,69,
2012,G,FREMONT,5026022011,1825,702,2527,1726,68.3,
2012,G,FREMONT,5026022012,655,489,1144,586,51.22,
2012,G,FREMONT,5026022013,826,479,1305,765,58.62,
2012,G,FREMONT,5026022014,683,331,1014,639,63.02,
2012,G,FREMONT,5026022015,569,239,808,535,66.21,
2012,G,FREMONT,5026022016,726,301,1027,682,66.41,
2012,G,FREMONT,5026022017,677,346,1023,630,61.58,
2012,G,FREMONT,5026022018,857,404,1261,800,63.44,
2012,G,FREMONT,5026022019,1552,858,2410,1419,58.88,
2012,G,FREMONT,5026022020,1090,538,1628,992,60.93,
2012,G,FREMONT,5026022021,548,173,721,516,71.57,
2012,G,FREMONT,5026022022,1131,500,1631,1053,64.56,
2012,G,FREMONT,5026022023,345,128,473,313,66.17,
2012,G,FREMONT,5026022024,593,253,846,567,67.02,
2012,G,FREMONT,5026022027,189,96,285,187,65.61,
2012,G,FREMONT,5026022029,464,147,611,450,73.65,
2012,G,FREMONT,5026022030,611,281,892,573,64.24,
2012,G,GARFIELD,3085723001,935,309,1244,854,68.65,
2012,G,GARFIELD,3085723002,1693,380,2073,1587,76.56,
2012,G,GARFIELD,3085723003,1174,341,1515,1081,71.35,
2012,G,GARFIELD,3085723004,1367,306,1673,1307,78.12,
2012,G,GARFIELD,3085723005,1206,429,1635,1149,70.28,
2012,G,GARFIELD,3085723006,845,335,1180,801,67.88,
2012,G,GARFIELD,3085723007,727,280,1007,693,68.82,
2012,G,GARFIELD,3085723008,823,323,1146,767,66.93,
2012,G,GARFIELD,3085723009,903,330,1233,870,70.56,
2012,G,GARFIELD,3085723010,1280,330,1610,1247,77.45,
2012,G,GARFIELD,3085723011,830,226,1056,817,77.37,
2012,G,GARFIELD,3085723012,992,391,1383,926,66.96,
2012,G,GARFIELD,3085723013,550,264,814,524,64.37,
2012,G,GARFIELD,3085723014,791,290,1081,740,68.46,
2012,G,GARFIELD,3085723015,1630,524,2154,1562,72.52,
2012,G,GARFIELD,3085723016,1224,418,1642,1189,72.41,
2012,G,GARFIELD,3085723017,1005,351,1356,979,72.2,
2012,G,GARFIELD,3085723018,602,129,731,577,78.93,
2012,G,GARFIELD,3085723019,1112,383,1495,1031,68.96,
2012,G,GARFIELD,3085723020,1030,368,1398,963,68.88,
2012,G,GARFIELD,3085723021,1104,399,1503,1039,69.13,
2012,G,GARFIELD,3085723022,826,447,1273,732,57.5,
2012,G,GARFIELD,3085723023,793,392,1185,712,60.08,
2012,G,GARFIELD,3085723024,433,108,541,413,76.34,
2012,G,GARFIELD,3085723025,410,248,658,391,59.42,
2012,G,GARFIELD,3085723026,1013,392,1405,953,67.83,
2012,G,GARFIELD,3085723027,786,499,1285,695,54.09,
2012,G,GILPIN,2161324001,567,181,748,707,94.52,
2012,G,GILPIN,2161324002,601,151,752,494,65.69,
2012,G,GILPIN,2161324003,736,288,1024,694,67.77,
2012,G,GILPIN,2161324004,539,265,804,519,64.55,
2012,G,GILPIN,2161324005,558,254,812,521,64.16,
2012,G,GILPIN,2161324006,663,287,950,438,46.11,
2012,G,GRAND,2081325001,688,256,944,631,66.84,
2012,G,GRAND,2081325002,984,366,1350,936,69.33,
2012,G,GRAND,2081325003,1179,479,1658,1091,65.8,
2012,G,GRAND,2081325004,559,248,807,517,64.06,
2012,G,GRAND,2081325005,796,317,1113,747,67.12,
2012,G,GRAND,2081325006,509,275,784,493,62.88,
2012,G,GRAND,2081325007,796,429,1225,739,60.33,
2012,G,GRAND,2081325008,597,202,799,548,68.59,
2012,G,GRAND,2081325009,519,215,734,483,65.8,
2012,G,GRAND,2081325010,702,222,924,641,69.37,
2012,G,GRAND,2081325011,543,204,747,506,67.74,
2012,G,GRAND,2081325012,788,236,1024,808,78.91,
2012,G,GUNNISON,3055926008,652,234,886,640,72.23,
2012,G,GUNNISON,3055926009,707,320,1027,684,66.6,
2012,G,GUNNISON,3055926010,511,502,1013,423,41.76,
2012,G,GUNNISON,3055926012,194,75,269,190,70.63,
2012,G,GUNNISON,3055926013,1013,332,1345,969,72.04,
2012,G,GUNNISON,3055926014,821,557,1378,782,56.75,
2012,G,GUNNISON,3055926015,417,346,763,395,51.77,
2012,G,GUNNISON,3056126001,85,60,145,72,49.66,
2012,G,GUNNISON,3056126002,268,69,337,246,73,
2012,G,GUNNISON,3056126003,1048,553,1601,1009,63.02,
2012,G,GUNNISON,3056126004,474,325,799,469,58.7,
2012,G,GUNNISON,3056126005,1275,536,1811,1289,71.18,
2012,G,GUNNISON,3056126006,632,266,898,606,67.48,
2012,G,GUNNISON,3056126007,627,187,814,630,77.4,
2012,G,GUNNISON,3056126011,267,110,377,259,68.7,
2012,G,HINSDALE,3055927001,665,75,740,614,82.97,
2012,G,HUERFANO,3356228001,351,104,455,338,74.29,
2012,G,HUERFANO,3356228002,855,223,1078,843,78.2,
2012,G,HUERFANO,3356228003,386,112,498,380,76.31,
2012,G,HUERFANO,3356228004,566,176,742,536,72.24,
2012,G,HUERFANO,3356228005,178,40,218,175,80.28,
2012,G,HUERFANO,3356228006,518,179,697,489,70.16,
2012,G,HUERFANO,3356228007,197,75,272,184,67.65,
2012,G,HUERFANO,3356228008,95,19,114,92,80.7,
2012,G,HUERFANO,3356228009,527,128,655,493,75.27,
2012,G,HUERFANO,3356228010,152,33,185,134,72.43,
2012,G,HUERFANO,3356228011,112,26,138,102,73.91,
2012,G,JACKSON,3081329001,354,107,461,324,70.28,
2012,G,JACKSON,3081329002,70,20,90,57,63.33,
2012,G,JACKSON,3081329003,126,24,150,116,77.33,
2012,G,JACKSON,3081329004,55,22,77,52,67.53,
2012,G,JACKSON,3081329005,339,140,479,313,65.34,
2012,G,JEFFERSON,1160130001,192,23,215,178,82.79,
2012,G,JEFFERSON,1162230002,1021,431,1452,976,67.22,
2012,G,JEFFERSON,1162230003,739,124,863,719,83.31,
2012,G,JEFFERSON,1162230004,2147,574,2721,2072,76.15,
2012,G,JEFFERSON,1162230005,965,169,1134,937,82.63,
2012,G,JEFFERSON,1162230006,1504,233,1737,1463,84.23,
2012,G,JEFFERSON,1162230007,1191,250,1441,1159,80.43,
2012,G,JEFFERSON,1162230008,1333,404,1737,1261,72.6,
2012,G,JEFFERSON,1162230009,1716,284,2000,1670,83.5,
2012,G,JEFFERSON,1162230010,793,124,917,785,85.61,
2012,G,JEFFERSON,1162230011,962,197,1159,960,82.83,
2012,G,JEFFERSON,1162230012,1863,358,2221,1805,81.27,
2012,G,JEFFERSON,1162230013,713,185,898,694,77.28,
2012,G,JEFFERSON,1162230014,1067,247,1314,1052,80.06,
2012,G,JEFFERSON,1202230015,341,135,476,324,68.07,
2012,G,JEFFERSON,1222230016,1263,327,1590,1233,77.55,
2012,G,JEFFERSON,1222230017,871,256,1127,846,75.07,
2012,G,JEFFERSON,1222230018,1501,252,1753,1461,83.34,
2012,G,JEFFERSON,1222230019,1635,322,1957,1593,81.4,
2012,G,JEFFERSON,1222230020,1965,567,2532,1887,74.53,
2012,G,JEFFERSON,1222230021,1333,235,1568,1303,83.1,
2012,G,JEFFERSON,1222230022,959,233,1192,919,77.1,
2012,G,JEFFERSON,1222230023,979,202,1181,968,81.96,
2012,G,JEFFERSON,1222230024,1846,431,2277,1805,79.27,
2012,G,JEFFERSON,1222230025,1147,258,1405,1121,79.79,
2012,G,JEFFERSON,1222230026,1257,364,1621,1245,76.8,
2012,G,JEFFERSON,1222230027,1228,183,1411,1181,83.7,
2012,G,JEFFERSON,1222230028,886,370,1256,852,67.83,
2012,G,JEFFERSON,1222230029,1326,351,1677,1289,76.86,
2012,G,JEFFERSON,1222230030,1503,418,1921,1450,75.48,
2012,G,JEFFERSON,1222230031,908,238,1146,884,77.14,
2012,G,JEFFERSON,1222230032,1149,422,1571,1108,70.53,
2012,G,JEFFERSON,1222230033,1796,481,2277,1745,76.64,
2012,G,JEFFERSON,1222230034,1933,431,2364,1833,77.54,
2012,G,JEFFERSON,1222230035,1077,211,1288,1028,79.81,
2012,G,JEFFERSON,1222230261,322,96,418,313,74.88,
2012,G,JEFFERSON,2162530036,1780,380,2160,1721,79.68,
2012,G,JEFFERSON,2162530037,1035,197,1232,1000,81.17,
2012,G,JEFFERSON,2162530038,938,185,1123,902,80.32,
2012,G,JEFFERSON,2162530039,1245,268,1513,1169,77.26,
2012,G,JEFFERSON,2162530040,619,106,725,606,83.59,
2012,G,JEFFERSON,2162530041,972,124,1096,946,86.31,
2012,G,JEFFERSON,2162530042,1168,246,1414,1131,79.99,
2012,G,JEFFERSON,2162530043,725,145,870,703,80.8,
2012,G,JEFFERSON,2162530044,904,253,1157,860,74.33,
2012,G,JEFFERSON,2162530045,992,211,1203,962,79.97,
2012,G,JEFFERSON,2162530046,971,325,1296,929,71.68,
2012,G,JEFFERSON,2162530047,875,180,1055,838,79.43,
2012,G,JEFFERSON,2162530048,1091,231,1322,1036,78.37,
2012,G,JEFFERSON,2162530049,1148,279,1427,1106,77.51,
2012,G,JEFFERSON,2162530050,1072,217,1289,1039,80.61,
2012,G,JEFFERSON,2162530051,1023,205,1228,985,80.21,
2012,G,JEFFERSON,2162530052,1242,324,1566,1193,76.18,
2012,G,JEFFERSON,2162530053,1143,223,1366,1096,80.23,
2012,G,JEFFERSON,2162530054,910,166,1076,887,82.43,
2012,G,JEFFERSON,2162530055,1070,191,1261,1027,81.44,
2012,G,JEFFERSON,2162530056,282,71,353,271,76.77,
2012,G,JEFFERSON,2162530057,976,194,1170,942,80.51,
2012,G,JEFFERSON,2162530058,282,78,360,270,75,
2012,G,JEFFERSON,2162530059,1077,272,1349,1022,75.76,
2012,G,JEFFERSON,2162530060,1213,229,1442,1152,79.89,
2012,G,JEFFERSON,2162530061,1193,286,1479,1162,78.57,
2012,G,JEFFERSON,2162530062,477,144,621,465,74.88,
2012,G,JEFFERSON,2162530063,1139,335,1474,1076,73,
2012,G,JEFFERSON,2162530064,1281,287,1568,1219,77.74,
2012,G,JEFFERSON,2162530065,1021,200,1221,993,81.33,
2012,G,JEFFERSON,2162530066,529,77,606,519,85.64,
2012,G,JEFFERSON,2162530067,1194,273,1467,1144,77.98,
2012,G,JEFFERSON,2162530068,1150,221,1371,1112,81.11,
2012,G,JEFFERSON,2162530069,1063,269,1332,1019,76.5,
2012,G,JEFFERSON,2162530070,881,149,1030,858,83.3,
2012,G,JEFFERSON,2162530071,320,60,380,313,82.37,
2012,G,JEFFERSON,2202230072,506,158,664,480,72.29,
2012,G,JEFFERSON,2202530073,1021,259,1280,998,77.97,
2012,G,JEFFERSON,2202530074,1111,294,1405,1079,76.8,
2012,G,JEFFERSON,2202530075,1294,452,1746,1235,70.73,
2012,G,JEFFERSON,2202530076,1050,256,1306,1000,76.57,
2012,G,JEFFERSON,2202530077,1516,363,1879,1462,77.81,
2012,G,JEFFERSON,2202530078,1841,656,2497,1754,70.24,
2012,G,JEFFERSON,2202530079,2121,432,2553,2068,81,
2012,G,JEFFERSON,2202530080,1256,168,1424,1219,85.6,
2012,G,JEFFERSON,2202530081,1258,205,1463,1239,84.69,
2012,G,JEFFERSON,2202530082,812,130,942,787,83.55,
2012,G,JEFFERSON,2202530083,1148,206,1354,1097,81.02,
2012,G,JEFFERSON,2222230084,1331,281,1612,1308,81.14,
2012,G,JEFFERSON,2222230085,1117,241,1358,1116,82.18,
2012,G,JEFFERSON,2222530086,825,128,953,809,84.89,
2012,G,JEFFERSON,7162430087,977,359,1336,909,68.04,
2012,G,JEFFERSON,7162430088,1200,511,1711,1100,64.29,
2012,G,JEFFERSON,7162430089,1363,288,1651,1303,78.92,
2012,G,JEFFERSON,7162430090,797,193,990,775,78.28,
2012,G,JEFFERSON,7162430091,1668,620,2288,1590,69.49,
2012,G,JEFFERSON,7162430092,1115,480,1595,1041,65.27,
2012,G,JEFFERSON,7162430093,1089,346,1435,981,68.36,
2012,G,JEFFERSON,7162430094,738,192,930,685,73.66,
2012,G,JEFFERSON,7162430095,941,94,1035,907,87.63,
2012,G,JEFFERSON,7162430096,527,65,592,505,85.3,
2012,G,JEFFERSON,7162430097,1063,172,1235,1033,83.64,
2012,G,JEFFERSON,7162430098,1202,320,1522,1112,73.06,
2012,G,JEFFERSON,7162430099,1048,383,1431,975,68.13,
2012,G,JEFFERSON,7162430100,1170,301,1471,1112,75.59,
2012,G,JEFFERSON,7162430262,122,82,204,103,50.49,
2012,G,JEFFERSON,7162530101,121,22,143,118,82.52,
2012,G,JEFFERSON,7162530102,328,51,379,322,84.96,
2012,G,JEFFERSON,7192430103,914,153,1067,887,83.13,
2012,G,JEFFERSON,7192730104,2112,305,2417,2039,84.36,
2012,G,JEFFERSON,7192730105,1757,400,2157,1736,80.48,
2012,G,JEFFERSON,7192730106,1654,439,2093,1625,77.64,
2012,G,JEFFERSON,7192730107,1111,212,1323,1046,79.06,
2012,G,JEFFERSON,7192730108,1544,209,1753,1507,85.97,
2012,G,JEFFERSON,7192730109,1132,271,1403,1096,78.12,
2012,G,JEFFERSON,7192730110,1221,384,1605,1143,71.21,
2012,G,JEFFERSON,7192730111,2089,492,2581,2031,78.69,
2012,G,JEFFERSON,7192730112,1073,215,1288,1064,82.61,
2012,G,JEFFERSON,7192730113,1173,251,1424,1125,79,
2012,G,JEFFERSON,7192730114,714,170,884,693,78.39,
2012,G,JEFFERSON,7192730115,1832,317,2149,1785,83.06,
2012,G,JEFFERSON,7192730116,1690,364,2054,1610,78.38,
2012,G,JEFFERSON,7192730117,1077,295,1372,1016,74.05,
2012,G,JEFFERSON,7192730118,1264,223,1487,1222,82.18,
2012,G,JEFFERSON,7192730119,1535,340,1875,1472,78.51,
2012,G,JEFFERSON,7192730120,1869,336,2205,1818,82.45,
2012,G,JEFFERSON,7192730121,1046,186,1232,1003,81.41,
2012,G,JEFFERSON,7192730122,1161,213,1374,1144,83.26,
2012,G,JEFFERSON,7192730123,956,171,1127,928,82.34,
2012,G,JEFFERSON,7192730124,1632,636,2268,1526,67.28,
2012,G,JEFFERSON,7192730125,1801,722,2523,1693,67.1,
2012,G,JEFFERSON,7192730126,1324,481,1805,1258,69.7,
2012,G,JEFFERSON,7192730127,2057,586,2643,1975,74.73,
2012,G,JEFFERSON,7192730128,1165,306,1471,1123,76.34,
2012,G,JEFFERSON,7192730129,1938,590,2528,1821,72.03,
2012,G,JEFFERSON,7192730130,1094,424,1518,998,65.74,
2012,G,JEFFERSON,7192730131,1384,225,1609,1335,82.97,
2012,G,JEFFERSON,7192930132,1361,371,1732,1350,77.94,
2012,G,JEFFERSON,7192930133,1091,420,1511,1021,67.57,
2012,G,JEFFERSON,7192930134,1067,313,1380,1036,75.07,
2012,G,JEFFERSON,7192930135,1147,307,1454,1098,75.52,
2012,G,JEFFERSON,7192930136,1093,369,1462,1076,73.6,
2012,G,JEFFERSON,7192930137,1210,303,1513,1192,78.78,
2012,G,JEFFERSON,7192930138,2169,1017,3186,2036,63.9,
2012,G,JEFFERSON,7192930139,1099,353,1452,1077,74.17,
2012,G,JEFFERSON,7192930140,2117,590,2707,1986,73.37,
2012,G,JEFFERSON,7192930141,1494,340,1834,1430,77.97,
2012,G,JEFFERSON,7192930142,1902,636,2538,1840,72.5,
2012,G,JEFFERSON,7192930143,1206,334,1540,1190,77.27,
2012,G,JEFFERSON,7192930144,1274,426,1700,1203,70.76,
2012,G,JEFFERSON,7192930145,1238,406,1644,1197,72.81,
2012,G,JEFFERSON,7192930146,1571,469,2040,1526,74.8,
2012,G,JEFFERSON,7192930147,1271,456,1727,1218,70.53,
2012,G,JEFFERSON,7192930148,1344,369,1713,1329,77.58,
2012,G,JEFFERSON,7192930149,955,259,1214,919,75.7,
2012,G,JEFFERSON,7192930150,1125,388,1513,1062,70.19,
2012,G,JEFFERSON,7192930151,1077,405,1482,987,66.6,
2012,G,JEFFERSON,7192930152,1237,404,1641,1148,69.96,
2012,G,JEFFERSON,7192930153,1242,496,1738,1152,66.28,
2012,G,JEFFERSON,7192930154,2131,625,2756,2032,73.73,
2012,G,JEFFERSON,7192930155,1007,258,1265,949,75.02,
2012,G,JEFFERSON,7192930156,1179,338,1517,1132,74.62,
2012,G,JEFFERSON,7192930157,1403,310,1713,1392,81.26,
2012,G,JEFFERSON,7192930158,1793,651,2444,1712,70.05,
2012,G,JEFFERSON,7192930159,1999,536,2535,1926,75.98,
2012,G,JEFFERSON,7192930160,1895,543,2438,1801,73.87,
2012,G,JEFFERSON,7192930161,1664,414,2078,1608,77.38,
2012,G,JEFFERSON,7202330162,1268,410,1678,1176,70.08,
2012,G,JEFFERSON,7202330163,1332,489,1821,1246,68.42,
2012,G,JEFFERSON,7202330164,1150,573,1723,1059,61.46,
2012,G,JEFFERSON,7202330165,831,303,1134,767,67.64,
2012,G,JEFFERSON,7202330166,1098,306,1404,1025,73.01,
2012,G,JEFFERSON,7202330167,1020,380,1400,972,69.43,
2012,G,JEFFERSON,7202330168,1624,220,1844,1566,84.92,
2012,G,JEFFERSON,7202330169,1556,260,1816,1505,82.87,
2012,G,JEFFERSON,7202330170,1781,442,2223,1682,75.66,
2012,G,JEFFERSON,7202330171,939,490,1429,903,63.19,
2012,G,JEFFERSON,7202330172,883,187,1070,851,79.53,
2012,G,JEFFERSON,7202330173,1247,178,1425,1211,84.98,
2012,G,JEFFERSON,7202330174,1465,237,1702,1439,84.55,
2012,G,JEFFERSON,7202330175,1189,246,1435,1149,80.07,
2012,G,JEFFERSON,7202330176,1781,431,2212,1717,77.62,
2012,G,JEFFERSON,7202330177,1597,823,2420,1460,60.33,
2012,G,JEFFERSON,7202330178,1659,395,2054,1581,76.97,
2012,G,JEFFERSON,7202330179,1563,462,2025,1499,74.02,
2012,G,JEFFERSON,7202330180,932,128,1060,906,85.47,
2012,G,JEFFERSON,7202330181,1564,364,1928,1525,79.1,
2012,G,JEFFERSON,7202330182,1816,539,2355,1771,75.2,
2012,G,JEFFERSON,7202330183,1920,636,2556,1796,70.27,
2012,G,JEFFERSON,7202330184,821,288,1109,746,67.27,
2012,G,JEFFERSON,7202330185,1408,358,1766,1380,78.14,
2012,G,JEFFERSON,7202430186,1233,244,1477,1190,80.57,
2012,G,JEFFERSON,7202430187,1206,154,1360,1172,86.18,
2012,G,JEFFERSON,7202430188,984,299,1283,915,71.32,
2012,G,JEFFERSON,7202430189,1879,360,2239,1801,80.44,
2012,G,JEFFERSON,7202430190,1594,422,2016,1515,75.15,
2012,G,JEFFERSON,7202430191,1164,202,1366,1129,82.65,
2012,G,JEFFERSON,7202430192,1001,303,1304,945,72.47,
2012,G,JEFFERSON,7202430193,1920,391,2311,1830,79.19,
2012,G,JEFFERSON,7202430194,926,424,1350,836,61.93,
2012,G,JEFFERSON,7202430195,950,212,1162,914,78.66,
2012,G,JEFFERSON,7202430196,1760,452,2212,1681,75.99,
2012,G,JEFFERSON,7202430197,1412,351,1763,1360,77.14,
2012,G,JEFFERSON,7202430198,1361,253,1614,1286,79.68,
2012,G,JEFFERSON,7202430199,1919,638,2557,1817,71.06,
2012,G,JEFFERSON,7202430200,1713,675,2388,1579,66.12,
2012,G,JEFFERSON,7202430201,995,205,1200,939,78.25,
2012,G,JEFFERSON,7202430202,924,288,1212,855,70.54,
2012,G,JEFFERSON,7202430203,673,240,913,601,65.83,
2012,G,JEFFERSON,7202430204,1109,168,1277,1057,82.77,
2012,G,JEFFERSON,7202430205,1331,392,1723,1253,72.72,
2012,G,JEFFERSON,7202430206,1479,321,1800,1435,79.72,
2012,G,JEFFERSON,7202530207,2023,425,2448,1997,81.58,
2012,G,JEFFERSON,7202530208,417,116,533,394,73.92,
2012,G,JEFFERSON,7202730209,1881,264,2145,1845,86.01,
2012,G,JEFFERSON,7202730210,2001,231,2232,1953,87.5,
2012,G,JEFFERSON,7202730211,1684,290,1974,1656,83.89,
2012,G,JEFFERSON,7202730212,1123,148,1271,1097,86.31,
2012,G,JEFFERSON,7202730213,953,205,1158,936,80.83,
2012,G,JEFFERSON,7202730214,1366,210,1576,1332,84.52,
2012,G,JEFFERSON,7202830215,1326,203,1529,1293,84.57,
2012,G,JEFFERSON,7202830216,1244,221,1465,1207,82.39,
2012,G,JEFFERSON,7202830217,1128,213,1341,1111,82.85,
2012,G,JEFFERSON,7202830218,1547,186,1733,1489,85.92,
2012,G,JEFFERSON,7202830219,1320,644,1964,1243,63.29,
2012,G,JEFFERSON,7202830220,1052,393,1445,989,68.44,
2012,G,JEFFERSON,7222230221,1923,282,2205,1896,85.99,
2012,G,JEFFERSON,7222230222,782,170,952,754,79.2,
2012,G,JEFFERSON,7222330223,948,397,1345,857,63.72,
2012,G,JEFFERSON,7222330224,1605,320,1925,1555,80.78,
2012,G,JEFFERSON,7222330225,1000,401,1401,888,63.38,
2012,G,JEFFERSON,7222330226,849,171,1020,814,79.8,
2012,G,JEFFERSON,7222330227,1163,612,1775,1018,57.35,
2012,G,JEFFERSON,7222330228,1066,522,1588,957,60.26,
2012,G,JEFFERSON,7222330229,1533,696,2229,1331,59.71,
2012,G,JEFFERSON,7222330230,1437,764,2201,1269,57.66,
2012,G,JEFFERSON,7222330231,913,220,1133,897,79.17,
2012,G,JEFFERSON,7222330232,1327,255,1582,1304,82.43,
2012,G,JEFFERSON,7222330233,1552,654,2206,1470,66.64,
2012,G,JEFFERSON,7222430234,2475,869,3344,2293,68.57,
2012,G,JEFFERSON,7222830235,2181,913,3094,2010,64.96,
2012,G,JEFFERSON,7222830236,877,235,1112,834,75,
2012,G,JEFFERSON,7222830237,1124,229,1353,1075,79.45,
2012,G,JEFFERSON,7222830238,1731,327,2058,1708,82.99,
2012,G,JEFFERSON,7222830239,1066,179,1245,1046,84.02,
2012,G,JEFFERSON,7222830240,1178,513,1691,1096,64.81,
2012,G,JEFFERSON,7222830241,874,391,1265,859,67.91,
2012,G,JEFFERSON,7222830242,1100,339,1439,1041,72.34,
2012,G,JEFFERSON,7222830243,1804,672,2476,1674,67.61,
2012,G,JEFFERSON,7222830244,1113,461,1574,1031,65.5,
2012,G,JEFFERSON,7222830245,1181,377,1558,1126,72.27,
2012,G,JEFFERSON,7222830246,1179,232,1411,1136,80.51,
2012,G,JEFFERSON,7222830247,1200,293,1493,1152,77.16,
2012,G,JEFFERSON,7222830248,1752,556,2308,1613,69.89,
2012,G,JEFFERSON,7222830249,867,187,1054,858,81.4,
2012,G,JEFFERSON,7222830250,1010,343,1353,910,67.26,
2012,G,JEFFERSON,7222830251,1147,453,1600,1059,66.19,
2012,G,JEFFERSON,7222830252,2027,1086,3113,1819,58.43,
2012,G,JEFFERSON,7222830253,1190,326,1516,1132,74.67,
2012,G,JEFFERSON,7222830254,1033,292,1325,957,72.23,
2012,G,JEFFERSON,7222830255,1540,420,1960,1477,75.36,
2012,G,JEFFERSON,7222830256,990,334,1324,944,71.3,
2012,G,JEFFERSON,7222830257,1363,308,1671,1305,78.1,
2012,G,JEFFERSON,7222830258,1149,364,1513,1082,71.51,
2012,G,JEFFERSON,7222830259,1663,340,2003,1589,79.33,
2012,G,JEFFERSON,7222830260,2021,540,2561,1884,73.57,
2012,G,KIOWA,4356431001,175,40,215,165,76.74,
2012,G,KIOWA,4356431002,279,62,341,270,79.18,
2012,G,KIOWA,4356431003,350,72,422,322,76.3,
2012,G,KIOWA,4356431004,86,9,95,83,87.37,
2012,G,KIT CARSON,4016532001,366,148,514,328,63.81,
2012,G,KIT CARSON,4016532002,275,128,403,242,60.05,
2012,G,KIT CARSON,4016532003,322,128,450,297,66,
2012,G,KIT CARSON,4016532004,312,69,381,293,76.9,
2012,G,KIT CARSON,4016532005,508,185,693,460,66.38,
2012,G,KIT CARSON,4016532006,315,73,388,298,76.8,
2012,G,KIT CARSON,4016532007,290,70,360,258,71.67,
2012,G,KIT CARSON,4016532008,271,64,335,247,73.73,
2012,G,KIT CARSON,4016532009,316,120,436,298,68.35,
2012,G,KIT CARSON,4016532010,153,37,190,139,73.16,
2012,G,KIT CARSON,4016532011,251,48,299,233,77.93,
2012,G,KIT CARSON,4016532012,237,83,320,224,70,
2012,G,KIT CARSON,4016532013,276,89,365,252,69.04,
2012,G,LA PLATA,3065934001,864,474,1338,784,58.59,
2012,G,LA PLATA,3065934002,701,285,986,638,64.71,
2012,G,LA PLATA,3065934003,395,150,545,368,67.52,
2012,G,LA PLATA,3065934004,956,284,1240,912,73.55,
2012,G,LA PLATA,3065934005,840,184,1024,796,77.73,
2012,G,LA PLATA,3065934006,849,219,1068,811,75.94,
2012,G,LA PLATA,3065934007,1060,441,1501,978,65.16,
2012,G,LA PLATA,3065934008,1104,384,1488,1024,68.82,
2012,G,LA PLATA,3065934009,765,196,961,711,73.99,
2012,G,LA PLATA,3065934010,591,197,788,571,72.46,
2012,G,LA PLATA,3065934011,1257,269,1526,1191,78.05,
2012,G,LA PLATA,3065934012,1029,375,1404,1021,72.72,
2012,G,LA PLATA,3065934013,1435,453,1888,1372,72.67,
2012,G,LA PLATA,3065934014,1103,290,1393,1076,77.24,
2012,G,LA PLATA,3065934015,475,192,667,450,67.47,
2012,G,LA PLATA,3065934016,730,229,959,662,69.03,
2012,G,LA PLATA,3065934017,1497,486,1983,1477,74.48,
2012,G,LA PLATA,3065934018,1225,355,1580,1167,73.86,
2012,G,LA PLATA,3065934019,1400,437,1837,1375,74.85,
2012,G,LA PLATA,3065934020,1087,386,1473,1040,70.6,
2012,G,LA PLATA,3065934021,1137,358,1495,1112,74.38,
2012,G,LA PLATA,3065934022,1717,597,2314,1648,71.22,
2012,G,LA PLATA,3065934023,1208,408,1616,1188,73.51,
2012,G,LA PLATA,3065934024,831,448,1279,786,61.45,
2012,G,LA PLATA,3065934025,394,93,487,383,78.64,
2012,G,LA PLATA,3065934026,1850,662,2512,1776,70.7,
2012,G,LA PLATA,3065934027,397,130,527,375,71.16,
2012,G,LA PLATA,3065934028,1061,292,1353,968,71.54,
2012,G,LA PLATA,3065934029,1097,335,1432,1023,71.44,
2012,G,LA PLATA,3065934030,1930,921,2851,1733,60.79,
2012,G,LAKE,3056133001,646,251,897,615,68.56,
2012,G,LAKE,3056133002,510,233,743,469,63.12,
2012,G,LAKE,3056133003,507,300,807,434,53.78,
2012,G,LAKE,3056133004,550,273,823,512,62.21,
2012,G,LAKE,3056133005,551,228,779,522,67.01,
2012,G,LAKE,3056133006,597,291,888,540,60.81,
2012,G,LARIMER,2145235201,951,261,1212,802,66.17,
2012,G,LARIMER,2145235202,1234,368,1602,1056,65.92,
2012,G,LARIMER,2145235203,1609,227,1836,1486,80.94,
2012,G,LARIMER,2145235204,1751,669,2420,1535,63.43,
2012,G,LARIMER,2145235205,1034,467,1501,917,61.09,
2012,G,LARIMER,2145235206,1355,420,1775,1230,69.3,
2012,G,LARIMER,2145235207,1193,406,1599,1064,66.54,
2012,G,LARIMER,2145235208,1415,465,1880,1257,66.86,
2012,G,LARIMER,2145235209,1340,322,1662,1258,75.69,
2012,G,LARIMER,2145235210,1243,414,1657,1083,65.36,
2012,G,LARIMER,2145235211,1570,378,1948,1419,72.84,
2012,G,LARIMER,2145235212,1015,157,1172,958,81.74,
2012,G,LARIMER,2145235213,1657,429,2086,1498,71.81,
2012,G,LARIMER,2145235214,1361,313,1674,1231,73.54,
2012,G,LARIMER,2145235215,936,307,1243,839,67.5,
2012,G,LARIMER,2145235216,883,283,1166,807,69.21,
2012,G,LARIMER,2145235217,1330,272,1602,1224,76.4,
2012,G,LARIMER,2145235218,1630,380,2010,1505,74.88,
2012,G,LARIMER,2145235219,1399,232,1631,1281,78.54,
2012,G,LARIMER,2145235220,1167,180,1347,1083,80.4,
2012,G,LARIMER,2145235221,1261,446,1707,1129,66.14,
2012,G,LARIMER,2145235222,1751,394,2145,1571,73.24,
2012,G,LARIMER,2145235223,1365,317,1682,1269,75.45,
2012,G,LARIMER,2145235224,946,244,1190,884,74.29,
2012,G,LARIMER,2145235225,1418,171,1589,1353,85.15,
2012,G,LARIMER,2145235226,1619,426,2045,1429,69.88,
2012,G,LARIMER,2145235227,1508,281,1789,1428,79.82,
2012,G,LARIMER,2145235228,1210,202,1412,1135,80.38,
2012,G,LARIMER,2145235229,1487,327,1814,1376,75.85,
2012,G,LARIMER,2145235230,1073,149,1222,1013,82.9,
2012,G,LARIMER,2145235231,1045,269,1314,973,74.05,
2012,G,LARIMER,2145235232,1108,177,1285,1077,83.81,
2012,G,LARIMER,2145235233,1124,218,1342,1054,78.54,
2012,G,LARIMER,2145235234,1080,159,1239,1022,82.49,
2012,G,LARIMER,2145235235,1052,224,1276,989,77.51,
2012,G,LARIMER,2145235236,1335,162,1497,1262,84.3,
2012,G,LARIMER,2145235237,1140,193,1333,1074,80.57,
2012,G,LARIMER,2145335301,1051,305,1356,937,69.1,
2012,G,LARIMER,2145335302,1655,408,2063,1526,73.97,
2012,G,LARIMER,2145335303,1225,308,1533,1127,73.52,
2012,G,LARIMER,2145335304,1700,550,2250,1471,65.38,
2012,G,LARIMER,2145335305,1415,519,1934,1276,65.98,
2012,G,LARIMER,2145335306,1740,717,2457,1503,61.17,
2012,G,LARIMER,2145335307,1736,801,2537,1516,59.76,
2012,G,LARIMER,2145335308,1802,926,2728,1519,55.68,
2012,G,LARIMER,2145335309,4350,2057,6407,3737,58.33,
2012,G,LARIMER,2145335310,1264,384,1648,1135,68.87,
2012,G,LARIMER,2145335311,1683,638,2321,1464,63.08,
2012,G,LARIMER,2145335312,1492,539,2031,1329,65.44,
2012,G,LARIMER,2145335313,1274,326,1600,1184,74,
2012,G,LARIMER,2145335314,1929,725,2654,1696,63.9,
2012,G,LARIMER,2145335315,1408,366,1774,1292,72.83,
2012,G,LARIMER,2145335316,978,189,1167,898,76.95,
2012,G,LARIMER,2145335317,1341,151,1492,1291,86.53,
2012,G,LARIMER,2145335318,1247,453,1700,1100,64.71,
2012,G,LARIMER,2145335319,1135,257,1392,1015,72.92,
2012,G,LARIMER,2145335320,950,266,1216,861,70.81,
2012,G,LARIMER,2145335321,1176,505,1681,1033,61.45,
2012,G,LARIMER,2145335322,1252,307,1559,1117,71.65,
2012,G,LARIMER,2145335323,1233,278,1511,1130,74.78,
2012,G,LARIMER,2145335324,1497,177,1674,1402,83.75,
2012,G,LARIMER,2145335325,1472,366,1838,1322,71.93,
2012,G,LARIMER,2145335326,1667,435,2102,1519,72.26,
2012,G,LARIMER,2145335327,1357,200,1557,1276,81.95,
2012,G,LARIMER,2145335328,1307,191,1498,1224,81.71,
2012,G,LARIMER,2145335329,978,167,1145,928,81.05,
2012,G,LARIMER,2145335330,1233,211,1444,1178,81.58,
2012,G,LARIMER,2145335331,771,167,938,717,76.44,
2012,G,LARIMER,2145335332,1712,350,2062,1567,75.99,
2012,G,LARIMER,2154935401,546,150,696,492,70.69,
2012,G,LARIMER,2154935402,1517,256,1773,1389,78.34,
2012,G,LARIMER,2154935403,1031,193,1224,938,76.63,
2012,G,LARIMER,2154935404,122,19,141,111,78.72,
2012,G,LARIMER,2154935405,658,114,772,611,79.15,
2012,G,LARIMER,2154935406,870,123,993,807,81.27,
2012,G,LARIMER,2154935407,1510,257,1767,1436,81.27,
2012,G,LARIMER,2154935408,1624,279,1903,1485,78.03,
2012,G,LARIMER,2154935409,1063,147,1210,983,81.24,
2012,G,LARIMER,2154935410,942,172,1114,850,76.3,
2012,G,LARIMER,2154935411,1249,188,1437,1179,82.05,
2012,G,LARIMER,2154935412,874,219,1093,787,72,
2012,G,LARIMER,2154935413,1169,226,1395,1075,77.06,
2012,G,LARIMER,2154935414,1102,217,1319,1066,80.82,
2012,G,LARIMER,2154935415,1207,348,1555,1118,71.9,
2012,G,LARIMER,2154935416,1279,202,1481,1224,82.65,
2012,G,LARIMER,2154935417,1058,137,1195,1005,84.1,
2012,G,LARIMER,2154935418,1342,186,1528,1240,81.15,
2012,G,LARIMER,2154935419,1238,167,1405,1166,82.99,
2012,G,LARIMER,2154935420,1251,319,1570,1153,73.44,
2012,G,LARIMER,2154935421,1421,298,1719,1299,75.57,
2012,G,LARIMER,2154935422,1075,168,1243,1006,80.93,
2012,G,LARIMER,2154935423,1257,159,1416,1177,83.12,
2012,G,LARIMER,2154935424,32,6,38,28,73.68,
2012,G,LARIMER,2154935425,157,18,175,146,83.43,
2012,G,LARIMER,2154935426,959,128,1087,909,83.62,
2012,G,LARIMER,2154935427,1244,189,1433,1179,82.27,
2012,G,LARIMER,2154935428,1128,189,1317,1051,79.8,
2012,G,LARIMER,2154935429,1538,375,1913,1381,72.19,
2012,G,LARIMER,2154935430,901,161,1062,832,78.34,
2012,G,LARIMER,2154935431,1673,405,2078,1543,74.25,
2012,G,LARIMER,2154935432,1360,361,1721,1215,70.6,
2012,G,LARIMER,2154935433,1154,303,1457,1024,70.28,
2012,G,LARIMER,2155135501,1085,237,1322,980,74.13,
2012,G,LARIMER,2155135502,1135,156,1291,1060,82.11,
2012,G,LARIMER,2155135503,1165,260,1425,1060,74.39,
2012,G,LARIMER,2155135504,1300,279,1579,1178,74.6,
2012,G,LARIMER,2155135505,1163,361,1524,1020,66.93,
2012,G,LARIMER,2155135506,1059,220,1279,928,72.56,
2012,G,LARIMER,2155135507,1379,188,1567,1310,83.6,
2012,G,LARIMER,2155135508,652,82,734,614,83.65,
2012,G,LARIMER,2155135509,796,179,975,725,74.36,
2012,G,LARIMER,2155135510,970,192,1162,891,76.68,
2012,G,LARIMER,2155135511,865,109,974,822,84.39,
2012,G,LARIMER,2155135512,1426,313,1739,1299,74.7,
2012,G,LARIMER,2155135513,1078,244,1322,1012,76.55,
2012,G,LARIMER,2155135514,1310,314,1624,1179,72.6,
2012,G,LARIMER,2155135515,1042,179,1221,947,77.56,
2012,G,LARIMER,2155135516,1379,147,1526,1313,86.04,
2012,G,LARIMER,2155135517,1804,440,2244,1590,70.86,
2012,G,LARIMER,2155135518,1442,365,1807,1306,72.27,
2012,G,LARIMER,2155135519,1261,250,1511,1130,74.78,
2012,G,LARIMER,2155135520,1273,353,1626,1147,70.54,
2012,G,LARIMER,2155135521,1184,227,1411,1079,76.47,
2012,G,LARIMER,2155135522,1381,183,1564,1299,83.06,
2012,G,LARIMER,2155135523,1027,154,1181,966,81.8,
2012,G,LARIMER,2155135524,1171,237,1408,1058,75.14,
2012,G,LARIMER,2155135525,473,49,522,460,88.12,
2012,G,LARIMER,2155135526,1274,196,1470,1201,81.7,
2012,G,LARIMER,2155135527,1186,279,1465,1069,72.97,
2012,G,LARIMER,2155135528,1429,337,1766,1288,72.93,
2012,G,LARIMER,2155135529,1421,450,1871,1257,67.18,
2012,G,LARIMER,2155135530,1305,272,1577,1188,75.33,
2012,G,LARIMER,2155135531,662,76,738,614,83.2,
2012,G,LARIMER,2155135532,1837,510,2347,1629,69.41,
2012,G,LARIMER,2155135533,1533,499,2032,1333,65.6,
2012,G,LARIMER,2155135534,1521,420,1941,1373,70.74,
2012,G,LARIMER,2155135535,1397,326,1723,1262,73.24,
2012,G,LARIMER,2155135536,1265,209,1474,1177,79.85,
2012,G,LARIMER,2155135537,1418,180,1598,1339,83.79,
2012,G,LARIMER,2155135538,1327,179,1506,1261,83.73,
2012,G,LARIMER,2155135539,1308,202,1510,1219,80.73,
2012,G,LARIMER,2155135540,1343,342,1685,1217,72.23,
2012,G,LARIMER,2155135541,1413,213,1626,1300,79.95,
2012,G,LARIMER,2155235601,400,193,593,333,56.16,
2012,G,LARIMER,2155235602,888,78,966,844,87.37,
2012,G,LARIMER,2155235603,1402,161,1563,1325,84.77,
2012,G,LARIMER,2155335701,1198,236,1434,1103,76.92,
2012,G,LARIMER,2155335702,1007,179,1186,948,79.93,
2012,G,LARIMER,2155335703,985,310,1295,823,63.55,
2012,G,LARIMER,2234935801,845,190,1035,762,73.62,
2012,G,LARIMER,2234935802,582,56,638,560,87.77,
2012,G,LARIMER,2234935803,796,86,882,741,84.01,
2012,G,LARIMER,2234935804,472,16,488,460,94.26,
2012,G,LARIMER,2234935805,1544,239,1783,1471,82.5,
2012,G,LARIMER,2234935806,837,129,966,807,83.54,
2012,G,LARIMER,2234935807,1069,151,1220,1013,83.03,
2012,G,LARIMER,2234935808,697,44,741,671,90.55,
2012,G,LARIMER,2234935809,1533,155,1688,1387,82.17,
2012,G,LARIMER,2235235101,810,274,1084,739,68.17,
2012,G,LARIMER,2235235102,235,15,250,226,90.4,
2012,G,LAS ANIMAS,4356436001,208,53,261,193,73.95,
2012,G,LAS ANIMAS,4356436002,97,43,140,91,65,
2012,G,LAS ANIMAS,4356436003,613,190,803,588,73.23,
2012,G,LAS ANIMAS,4356436004,527,162,689,501,72.71,
2012,G,LAS ANIMAS,4356436005,353,147,500,339,67.8,
2012,G,LAS ANIMAS,4356436006,373,148,521,358,68.71,
2012,G,LAS ANIMAS,4356436007,431,160,591,429,72.59,
2012,G,LAS ANIMAS,4356436008,246,81,327,229,70.03,
2012,G,LAS ANIMAS,4356436009,438,127,565,414,73.27,
2012,G,LAS ANIMAS,4356436010,634,263,897,571,63.66,
2012,G,LAS ANIMAS,4356436011,678,334,1012,618,61.07,
2012,G,LAS ANIMAS,4356436012,617,279,896,582,64.96,
2012,G,LAS ANIMAS,4356436013,414,202,616,404,65.58,
2012,G,LAS ANIMAS,4356436014,451,182,633,406,64.14,
2012,G,LAS ANIMAS,4356436015,679,275,954,615,64.47,
2012,G,LAS ANIMAS,4356436016,640,252,892,645,72.31,
2012,G,LINCOLN,4016437001,199,60,259,197,76.06,
2012,G,LINCOLN,4016437002,314,157,471,300,63.69,
2012,G,LINCOLN,4016437003,236,104,340,237,69.71,
2012,G,LINCOLN,4016437004,175,57,232,178,76.72,
2012,G,LINCOLN,4016437005,242,118,360,220,61.11,
2012,G,LINCOLN,4016437006,217,64,281,212,75.44,
2012,G,LINCOLN,4016437007,305,134,439,301,68.56,
2012,G,LINCOLN,4016437008,49,5,54,46,85.19,
2012,G,LINCOLN,4016437009,114,42,156,104,66.67,
2012,G,LINCOLN,4016437010,160,29,189,153,80.95,
2012,G,LINCOLN,4016437011,55,17,72,51,70.83,
2012,G,LINCOLN,4016437012,39,4,43,33,76.74,
2012,G,LINCOLN,4016437013,285,82,367,279,76.02,
2012,G,LOGAN,4016538001,782,268,1050,747,71.14,
2012,G,LOGAN,4016538002,716,319,1035,669,64.64,
2012,G,LOGAN,4016538003,426,203,629,391,62.16,
2012,G,LOGAN,4016538004,728,379,1107,682,61.61,
2012,G,LOGAN,4016538005,616,247,863,551,63.85,
2012,G,LOGAN,4016538006,631,142,773,619,80.08,
2012,G,LOGAN,4016538007,934,204,1138,893,78.47,
2012,G,LOGAN,4016538008,932,157,1089,905,83.1,
2012,G,LOGAN,4016538009,967,149,1116,923,82.71,
2012,G,LOGAN,4016538010,695,181,876,687,78.42,
2012,G,LOGAN,4016538011,430,87,517,420,81.24,
2012,G,LOGAN,4016538012,339,55,394,343,87.06,
2012,G,LOGAN,4016538013,493,100,593,480,80.94,
2012,G,LOGAN,4016538014,315,62,377,320,84.88,
2012,G,LOGAN,4016538015,408,100,508,408,80.31,
2012,G,LOGAN,4016538016,218,34,252,208,82.54,
2012,G,MESA,3075439001,1263,392,1655,1258,76.01,
2012,G,MESA,3075439002,1326,351,1677,1262,75.25,
2012,G,MESA,3075439003,1292,377,1669,1233,73.88,
2012,G,MESA,3075439004,1599,628,2227,1498,67.27,
2012,G,MESA,3075439005,1207,285,1492,1140,76.41,
2012,G,MESA,3075439006,1583,536,2119,1498,70.69,
2012,G,MESA,3075439007,1269,568,1837,1156,62.93,
2012,G,MESA,3075439008,760,108,868,722,83.18,
2012,G,MESA,3075439009,845,156,1001,812,81.12,
2012,G,MESA,3075439010,866,236,1102,797,72.32,
2012,G,MESA,3075439011,178,53,231,173,74.89,
2012,G,MESA,3075439012,1091,265,1356,1041,76.77,
2012,G,MESA,3075439013,2312,855,3167,2156,68.08,
2012,G,MESA,3075439014,433,93,526,415,78.9,
2012,G,MESA,3075439015,911,176,1087,864,79.48,
2012,G,MESA,3075439016,727,198,925,725,78.38,
2012,G,MESA,3075439017,896,247,1143,800,69.99,
2012,G,MESA,3075439018,736,291,1027,711,69.23,
2012,G,MESA,3075439019,483,175,658,462,70.21,
2012,G,MESA,3075439020,1665,489,2154,1519,70.52,
2012,G,MESA,3075439021,1669,571,2240,1541,68.79,
2012,G,MESA,3075439022,1558,677,2235,1400,62.64,
2012,G,MESA,3075439023,1603,867,2470,1374,55.63,
2012,G,MESA,3075439024,1906,1271,3177,1671,52.6,
2012,G,MESA,3075439025,2006,575,2581,1898,73.54,
2012,G,MESA,3075439026,1761,958,2719,1546,56.86,
2012,G,MESA,3075439027,1341,401,1742,1254,71.99,
2012,G,MESA,3075439028,1281,201,1482,1243,83.87,
2012,G,MESA,3075439029,1350,236,1586,1281,80.77,
2012,G,MESA,3075539030,2164,859,3023,1943,64.27,
2012,G,MESA,3075539031,1160,246,1406,1102,78.38,
2012,G,MESA,3075539032,1070,218,1288,1021,79.27,
2012,G,MESA,3075539033,1591,308,1899,1518,79.94,
2012,G,MESA,3075539034,862,163,1025,834,81.37,
2012,G,MESA,3075539035,1307,273,1580,1235,78.16,
2012,G,MESA,3075539036,947,165,1112,924,83.09,
2012,G,MESA,3075539037,1021,282,1303,952,73.06,
2012,G,MESA,3075539038,1839,604,2443,1691,69.22,
2012,G,MESA,3075539039,1749,1062,2811,1546,55,
2012,G,MESA,3075539040,1501,521,2022,1407,69.58,
2012,G,MESA,3075539041,751,160,911,712,78.16,
2012,G,MESA,3075539042,1539,236,1775,1477,83.21,
2012,G,MESA,3075539043,1494,537,2031,1365,67.21,
2012,G,MESA,3075539044,1738,781,2519,1556,61.77,
2012,G,MESA,3075539045,2925,1422,4347,2561,58.91,
2012,G,MESA,3075539046,1699,506,2205,1564,70.93,
2012,G,MESA,3075539047,1758,325,2083,1693,81.28,
2012,G,MESA,3075539048,1573,356,1929,1476,76.52,
2012,G,MESA,3075539049,1951,830,2781,1735,62.39,
2012,G,MESA,3075539050,1954,692,2646,1824,68.93,
2012,G,MESA,3075539051,917,276,1193,868,72.76,
2012,G,MESA,3075539052,896,436,1332,820,61.56,
2012,G,MESA,3075539053,2209,980,3189,1990,62.4,
2012,G,MESA,3075539054,1968,1130,3098,1674,54.03,
2012,G,MESA,3075539055,1394,647,2041,1267,62.08,
2012,G,MESA,3075539056,1727,758,2485,1547,62.25,
2012,G,MESA,3075539057,1923,448,2371,1823,76.89,
2012,G,MINERAL,3356240001,710,127,837,674,80.53,
2012,G,MOFFAT,3085741001,1119,517,1636,1077,65.83,
2012,G,MOFFAT,3085741002,530,278,808,486,60.15,
2012,G,MOFFAT,3085741003,972,332,1304,949,72.78,
2012,G,MOFFAT,3085741004,34,15,49,83,169.39,Ballot style error; contact county for more information
2012,G,MOFFAT,3085741005,759,379,1138,741,65.11,
2012,G,MOFFAT,3085741006,215,56,271,143,52.77,
2012,G,MOFFAT,3085741007,605,278,883,573,64.89,
2012,G,MOFFAT,3085741008,220,126,346,195,56.36,
2012,G,MOFFAT,3085741009,659,369,1028,632,61.48,
2012,G,MOFFAT,3085741010,109,25,134,109,81.34,
2012,G,MOFFAT,3085741011,510,311,821,472,57.49,
2012,G,MOFFAT,3085741012,334,200,534,323,60.49,
2012,G,MOFFAT,3085741013,349,160,509,330,64.83,
2012,G,MONTEZUMA,3065842001,388,96,484,381,78.72,
2012,G,MONTEZUMA,3065842002,1994,775,2769,1834,66.23,
2012,G,MONTEZUMA,3065842003,1447,387,1834,1382,75.35,
2012,G,MONTEZUMA,3065842004,1537,441,1978,1426,72.09,
2012,G,MONTEZUMA,3065842005,821,307,1128,767,68,
2012,G,MONTEZUMA,3065842006,299,421,720,247,34.31,
2012,G,MONTEZUMA,3065842007,1656,836,2492,1478,59.31,
2012,G,MONTEZUMA,3065842008,1246,596,1842,1117,60.64,
2012,G,MONTEZUMA,3065842009,1189,792,1981,1049,52.95,
2012,G,MONTEZUMA,3065842010,1161,447,1608,1075,66.85,
2012,G,MONTEZUMA,3065842011,1845,755,2600,1724,66.31,
2012,G,MONTROSE,3065843001,897,203,1100,841,76.45,
2012,G,MONTROSE,3065843002,863,153,1016,839,82.58,
2012,G,MONTROSE,3065843003,1091,483,1574,1014,64.42,
2012,G,MONTROSE,3065843004,1017,455,1472,940,63.86,
2012,G,MONTROSE,3065843005,682,158,840,633,75.36,
2012,G,MONTROSE,3065843006,838,195,1033,798,77.25,
2012,G,MONTROSE,3065843007,624,286,910,579,63.63,
2012,G,MONTROSE,3065843008,329,126,455,314,69.01,
2012,G,MONTROSE,3065843009,1057,409,1466,971,66.23,
2012,G,MONTROSE,3065843010,117,33,150,113,75.33,
2012,G,MONTROSE,3065843011,140,22,162,137,84.57,
2012,G,MONTROSE,3065843012,902,246,1148,840,73.17,
2012,G,MONTROSE,3065843013,831,246,1077,785,72.89,
2012,G,MONTROSE,3065843014,621,152,773,581,75.16,
2012,G,MONTROSE,3065843015,20,0,20,19,95,
2012,G,MONTROSE,3065843016,307,68,375,300,80,
2012,G,MONTROSE,3065843017,860,234,1094,799,73.03,
2012,G,MONTROSE,3065843018,811,175,986,768,77.89,
2012,G,MONTROSE,3065843019,781,174,955,759,79.48,
2012,G,MONTROSE,3065843020,1090,376,1466,1022,69.71,
2012,G,MONTROSE,3065843021,890,237,1127,857,76.04,
2012,G,MONTROSE,3065843022,883,197,1080,845,78.24,
2012,G,MONTROSE,3065843023,1079,284,1363,1031,75.64,
2012,G,MONTROSE,3065843024,893,233,1126,837,74.33,
2012,G,MONTROSE,3065843025,1040,194,1234,1002,81.2,
2012,G,MONTROSE,3065843026,801,149,950,769,80.95,
2012,G,MONTROSE,3065843027,787,363,1150,732,63.65,
2012,G,MONTROSE,3065843028,950,293,1243,887,71.36,
2012,G,MORGAN,4016544001,1196,334,1530,1164,76.08,
2012,G,MORGAN,4016544002,505,121,626,470,75.08,
2012,G,MORGAN,4016544003,720,240,960,662,68.96,
2012,G,MORGAN,4016544004,736,230,966,695,71.95,
2012,G,MORGAN,4016544005,767,258,1025,720,70.24,
2012,G,MORGAN,4016544006,787,308,1095,723,66.03,
2012,G,MORGAN,4016544007,596,228,824,528,64.08,
2012,G,MORGAN,4016544008,550,279,829,490,59.11,
2012,G,MORGAN,4016544009,694,242,936,663,70.83,
2012,G,MORGAN,4016544010,809,234,1043,735,70.47,
2012,G,MORGAN,4016544011,831,159,990,810,81.82,
2012,G,MORGAN,4016544012,217,58,275,206,74.91,
2012,G,MORGAN,4016544013,398,110,508,389,76.57,
2012,G,MORGAN,4016544014,587,189,776,543,69.97,
2012,G,MORGAN,4016544015,642,279,921,610,66.23,
2012,G,MORGAN,4016544016,753,274,1027,704,68.55,
2012,G,MORGAN,4016544017,861,234,1095,813,74.25,
2012,G,OTERO,4354745001,807,319,1126,807,71.67,
2012,G,OTERO,4354745002,447,163,610,369,60.49,
2012,G,OTERO,4354745003,731,216,947,715,75.5,
2012,G,OTERO,4354745004,525,166,691,525,75.98,
2012,G,OTERO,4354745005,396,309,705,367,52.06,
2012,G,OTERO,4354745006,397,101,498,372,74.7,
2012,G,OTERO,4354745007,379,206,585,361,61.71,
2012,G,OTERO,4354745008,512,233,745,491,65.91,
2012,G,OTERO,4354745009,506,218,724,467,64.5,
2012,G,OTERO,4354745010,405,239,644,366,56.83,
2012,G,OTERO,4354745011,548,173,721,549,76.14,
2012,G,OTERO,4354745012,645,284,929,603,64.91,
2012,G,OTERO,4354745013,461,325,786,438,55.73,
2012,G,OTERO,4354745014,675,269,944,643,68.11,
2012,G,OTERO,4354745015,416,143,559,384,68.69,
2012,G,OTERO,4354745016,591,162,753,571,75.83,
2012,G,OTERO,4354745017,316,127,443,282,63.66,
2012,G,OURAY,3065946001,456,144,600,439,73.17,
2012,G,OURAY,3065946002,597,211,808,574,71.04,
2012,G,OURAY,3065946003,1038,276,1314,1020,77.63,
2012,G,OURAY,3065946004,481,133,614,465,75.73,
2012,G,OURAY,3065946005,755,301,1056,740,70.08,
2012,G,PARK,2026047008,657,210,867,636,73.36,
2012,G,PARK,2026047010,979,339,1318,897,68.06,
2012,G,PARK,2026047011,778,171,949,725,76.4,
2012,G,PARK,2026047012,1400,378,1778,1327,74.63,
2012,G,PARK,2026047013,1220,281,1501,1140,75.95,
2012,G,PARK,5026047001,1253,437,1690,1172,69.35,
2012,G,PARK,5026047002,615,296,911,597,65.53,
2012,G,PARK,5026047003,642,204,846,605,71.51,
2012,G,PARK,5026047004,220,68,288,212,73.61,
2012,G,PARK,5026047005,519,105,624,488,78.21,
2012,G,PARK,5026047006,640,134,774,607,78.42,
2012,G,PARK,5026047007,617,194,811,575,70.9,
2012,G,PARK,5026047009,501,168,669,481,71.9,
2012,G,PHILLIPS,4016548001,382,115,497,366,73.64,
2012,G,PHILLIPS,4016548002,85,34,119,86,72.27,
2012,G,PHILLIPS,4016548003,274,108,382,256,67.02,
2012,G,PHILLIPS,4016548004,491,168,659,475,72.08,
2012,G,PHILLIPS,4016548005,179,36,215,181,84.19,
2012,G,PHILLIPS,4016548006,337,104,441,327,74.15,
2012,G,PHILLIPS,4016548007,413,131,544,404,74.26,
2012,G,PHILLIPS,4016548008,199,92,291,189,64.95,
2012,G,PITKIN,3056149001,1173,421,1594,1117,70.08,
2012,G,PITKIN,3056149002,1063,594,1657,968,58.42,
2012,G,PITKIN,3056149003,983,377,1360,924,67.94,
2012,G,PITKIN,3056149004,1034,420,1454,972,66.85,
2012,G,PITKIN,3056149005,982,366,1348,925,68.62,
2012,G,PITKIN,3056149006,1547,670,2217,1415,63.82,
2012,G,PITKIN,3056149007,1507,598,2105,1434,68.12,
2012,G,PITKIN,3056149008,685,233,918,654,71.24,
2012,G,PITKIN,3056149009,1005,386,1391,925,66.5,
2012,G,PITKIN,3056149010,641,235,876,599,68.38,
2012,G,PROWERS,4356450001,317,180,497,291,58.55,
2012,G,PROWERS,4356450002,329,116,445,296,66.52,
2012,G,PROWERS,4356450003,346,126,472,328,69.49,
2012,G,PROWERS,4356450004,316,145,461,310,67.25,
2012,G,PROWERS,4356450005,360,222,582,322,55.33,
2012,G,PROWERS,4356450006,389,98,487,374,76.8,
2012,G,PROWERS,4356450007,439,145,584,424,72.6,
2012,G,PROWERS,4356450008,547,205,752,481,63.96,
2012,G,PROWERS,4356450009,296,151,447,275,61.52,
2012,G,PROWERS,4356450010,711,249,960,671,69.9,
2012,G,PROWERS,4356450011,438,161,599,403,67.28,
2012,G,PROWERS,4356450012,455,122,577,424,73.48,
2012,G,PROWERS,4356450013,380,91,471,341,72.4,
2012,G,PUEBLO,3034651020,141,77,218,123,56.42,
2012,G,PUEBLO,3034651021,666,328,994,557,56.04,
2012,G,PUEBLO,3034651036,598,150,748,558,74.6,
2012,G,PUEBLO,3034651037,542,109,651,509,78.19,
2012,G,PUEBLO,3034651038,659,253,912,612,67.11,
2012,G,PUEBLO,3034651039,284,190,474,250,52.74,
2012,G,PUEBLO,3034651040,379,115,494,352,71.26,
2012,G,PUEBLO,3034651041,409,173,582,366,62.89,
2012,G,PUEBLO,3034651042,425,194,619,323,52.18,
2012,G,PUEBLO,3034651043,353,190,543,298,54.88,
2012,G,PUEBLO,3034651044,354,187,541,301,55.64,
2012,G,PUEBLO,3034651048,453,230,683,393,57.54,
2012,G,PUEBLO,3034651049,371,147,518,338,65.25,
2012,G,PUEBLO,3034651050,750,376,1126,648,57.55,
2012,G,PUEBLO,3034651051,816,336,1152,703,61.02,
2012,G,PUEBLO,3034651052,600,223,823,539,65.49,
2012,G,PUEBLO,3034651053,504,162,666,469,70.42,
2012,G,PUEBLO,3034651054,412,193,605,358,59.17,
2012,G,PUEBLO,3034651055,523,128,651,508,78.03,
2012,G,PUEBLO,3034651056,503,95,598,480,80.27,
2012,G,PUEBLO,3034651057,686,163,849,647,76.21,
2012,G,PUEBLO,3034651058,618,111,729,589,80.8,
2012,G,PUEBLO,3034651059,343,165,508,332,65.35,
2012,G,PUEBLO,3034651060,664,167,831,626,75.33,
2012,G,PUEBLO,3034651061,617,164,781,568,72.73,
2012,G,PUEBLO,3034651062,679,163,842,647,76.84,
2012,G,PUEBLO,3034651063,944,274,1218,867,71.18,
2012,G,PUEBLO,3034651064,185,72,257,156,60.7,
2012,G,PUEBLO,3034651065,70,3,73,68,93.15,
2012,G,PUEBLO,3034651066,774,121,895,750,83.8,
2012,G,PUEBLO,3034651067,565,180,745,514,68.99,
2012,G,PUEBLO,3034651068,441,121,562,407,72.42,
2012,G,PUEBLO,3034651069,689,231,920,652,70.87,
2012,G,PUEBLO,3034651070,533,310,843,426,50.53,
2012,G,PUEBLO,3034651071,573,234,807,497,61.59,
2012,G,PUEBLO,3034651072,565,255,820,514,62.68,
2012,G,PUEBLO,3034651073,524,267,791,430,54.36,
2012,G,PUEBLO,3034651074,590,288,878,530,60.36,
2012,G,PUEBLO,3034651075,695,304,999,608,60.86,
2012,G,PUEBLO,3034651076,350,160,510,329,64.51,
2012,G,PUEBLO,3034651077,376,253,629,332,52.78,
2012,G,PUEBLO,3034651078,403,173,576,357,61.98,
2012,G,PUEBLO,3034651079,583,253,836,497,59.45,
2012,G,PUEBLO,3034651080,770,241,1011,721,71.32,
2012,G,PUEBLO,3034651081,660,181,841,601,71.46,
2012,G,PUEBLO,3034651082,1019,310,1329,975,73.36,
2012,G,PUEBLO,3034651083,649,196,845,593,70.18,
2012,G,PUEBLO,3034651084,753,199,952,709,74.47,
2012,G,PUEBLO,3034651085,602,215,817,553,67.69,
2012,G,PUEBLO,3034651086,940,319,1259,858,68.15,
2012,G,PUEBLO,3034651087,762,134,896,728,81.25,
2012,G,PUEBLO,3034651088,1309,265,1574,1280,81.32,
2012,G,PUEBLO,3034651209,883,183,1066,838,78.61,
2012,G,PUEBLO,3034651210,434,207,641,409,63.81,
2012,G,PUEBLO,3034651211,763,397,1160,714,61.55,
2012,G,PUEBLO,3034651212,660,387,1047,601,57.4,
2012,G,PUEBLO,3034651213,1155,225,1380,1094,79.28,
2012,G,PUEBLO,3034651214,1254,461,1715,1186,69.15,
2012,G,PUEBLO,3034651215,1027,262,1289,994,77.11,
2012,G,PUEBLO,3034651216,700,188,888,665,74.89,
2012,G,PUEBLO,3034651217,524,125,649,491,75.65,
2012,G,PUEBLO,3034651218,1011,275,1286,961,74.73,
2012,G,PUEBLO,3034651219,930,227,1157,887,76.66,
2012,G,PUEBLO,3034651220,812,223,1035,773,74.69,
2012,G,PUEBLO,3034751001,828,307,1135,718,63.26,
2012,G,PUEBLO,3034751002,1250,437,1687,1149,68.11,
2012,G,PUEBLO,3034751003,1232,435,1667,1119,67.13,
2012,G,PUEBLO,3034751004,1038,206,1244,994,79.9,
2012,G,PUEBLO,3034751005,551,133,684,521,76.17,
2012,G,PUEBLO,3034751006,721,255,976,578,59.22,
2012,G,PUEBLO,3034751007,894,265,1159,849,73.25,
2012,G,PUEBLO,3034751008,987,230,1217,934,76.75,
2012,G,PUEBLO,3034751009,634,186,820,603,73.54,
2012,G,PUEBLO,3034751010,957,643,1600,838,52.38,
2012,G,PUEBLO,3034751011,851,253,1104,781,70.74,
2012,G,PUEBLO,3034751015,782,360,1142,732,64.1,
2012,G,PUEBLO,3034751016,752,325,1077,669,62.12,
2012,G,PUEBLO,3034751017,800,236,1036,762,73.55,
2012,G,PUEBLO,3034751018,1180,501,1681,1050,62.46,
2012,G,PUEBLO,3034751019,245,109,354,226,63.84,
2012,G,PUEBLO,3034751022,467,230,697,394,56.53,
2012,G,PUEBLO,3034751023,834,350,1184,751,63.43,
2012,G,PUEBLO,3034751024,747,278,1025,700,68.29,
2012,G,PUEBLO,3034751033,172,132,304,144,47.37,
2012,G,PUEBLO,3034751034,616,430,1046,481,45.98,
2012,G,PUEBLO,3034751035,190,116,306,157,51.31,
2012,G,PUEBLO,3034751113,546,247,793,500,63.05,
2012,G,PUEBLO,3034751201,1050,296,1346,966,71.77,
2012,G,PUEBLO,3034751202,833,235,1068,767,71.82,
2012,G,PUEBLO,3034751203,926,356,1282,859,67,
2012,G,PUEBLO,3034751204,586,174,760,536,70.53,
2012,G,PUEBLO,3034751205,570,226,796,520,65.33,
2012,G,PUEBLO,3034751206,827,400,1227,759,61.86,
2012,G,PUEBLO,3034751207,846,344,1190,809,67.98,
2012,G,PUEBLO,3034751208,992,448,1440,903,62.71,
2012,G,PUEBLO,3036251012,937,321,1258,857,68.12,
2012,G,PUEBLO,3036251013,892,462,1354,772,57.02,
2012,G,PUEBLO,3036251014,571,315,886,503,56.77,
2012,G,PUEBLO,3036251025,559,364,923,478,51.79,
2012,G,PUEBLO,3036251026,688,263,951,624,65.62,
2012,G,PUEBLO,3036251027,648,267,915,572,62.51,
2012,G,PUEBLO,3036251028,583,380,963,478,49.64,
2012,G,PUEBLO,3036251029,465,225,690,369,53.48,
2012,G,PUEBLO,3036251030,699,345,1044,601,57.57,
2012,G,PUEBLO,3036251031,748,408,1156,625,54.07,
2012,G,PUEBLO,3036251032,451,283,734,351,47.82,
2012,G,PUEBLO,3036251045,156,71,227,122,53.74,
2012,G,PUEBLO,3036251046,589,290,879,511,58.13,
2012,G,PUEBLO,3036251047,464,205,669,388,58,
2012,G,PUEBLO,3036251101,325,97,422,303,71.8,
2012,G,PUEBLO,3036251102,585,172,757,559,73.84,
2012,G,PUEBLO,3036251104,768,168,936,720,76.92,
2012,G,PUEBLO,3354651301,1269,389,1658,1229,74.13,
2012,G,PUEBLO,3354651302,801,236,1037,793,76.47,
2012,G,PUEBLO,3354651303,391,82,473,365,77.17,
2012,G,PUEBLO,3354651401,716,123,839,674,80.33,
2012,G,PUEBLO,3354651402,706,157,863,643,74.51,
2012,G,PUEBLO,3354651403,685,158,843,671,79.6,
2012,G,PUEBLO,3354751106,817,170,987,785,79.53,
2012,G,PUEBLO,3354751107,1194,291,1485,1127,75.89,
2012,G,PUEBLO,3354751108,615,144,759,582,76.68,
2012,G,PUEBLO,3354751109,571,195,766,553,72.19,
2012,G,PUEBLO,3354751110,174,54,228,164,71.93,
2012,G,PUEBLO,3354751111,469,218,687,453,65.94,
2012,G,PUEBLO,3354751112,327,115,442,302,68.33,
2012,G,PUEBLO,3356251103,679,165,844,655,77.61,
2012,G,PUEBLO,3356251105,1118,240,1358,1063,78.28,
2012,G,PUEBLO,3356251304,367,67,434,351,80.88,
2012,G,RIO BLANCO,3085752001,791,298,1089,755,69.33,
2012,G,RIO BLANCO,3085752002,655,217,872,604,69.27,
2012,G,RIO BLANCO,3085752003,919,360,1279,860,67.24,
2012,G,RIO BLANCO,3085752004,1140,279,1419,1083,76.32,
2012,G,RIO BLANCO,3085752005,54,10,64,50,78.13,
2012,G,RIO GRANDE,3356253001,254,92,346,233,67.34,
2012,G,RIO GRANDE,3356253002,390,184,574,384,66.9,
2012,G,RIO GRANDE,3356253003,617,229,846,595,70.33,
2012,G,RIO GRANDE,3356253004,287,97,384,260,67.71,
2012,G,RIO GRANDE,3356253005,396,88,484,372,76.86,
2012,G,RIO GRANDE,3356253006,150,37,187,142,75.94,
2012,G,RIO GRANDE,3356253007,424,108,532,411,77.26,
2012,G,RIO GRANDE,3356253008,484,129,613,450,73.41,
2012,G,RIO GRANDE,3356253009,351,141,492,336,68.29,
2012,G,RIO GRANDE,3356253010,798,308,1106,756,68.35,
2012,G,RIO GRANDE,3356253011,433,142,575,419,72.87,
2012,G,RIO GRANDE,3356253012,319,104,423,294,69.5,
2012,G,RIO GRANDE,3356253013,304,75,379,291,76.78,
2012,G,RIO GRANDE,3356253014,403,140,543,379,69.8,
2012,G,RIO GRANDE,3356253015,313,132,445,297,66.74,
2012,G,ROUTT,3082654001,698,176,874,669,76.54,
2012,G,ROUTT,3082654002,501,153,654,480,73.39,
2012,G,ROUTT,3082654003,910,169,1079,858,79.52,
2012,G,ROUTT,3082654004,545,122,667,516,77.36,
2012,G,ROUTT,3082654005,927,288,1215,870,71.6,
2012,G,ROUTT,3082654006,987,194,1181,931,78.83,
2012,G,ROUTT,3082654007,421,109,530,385,72.64,
2012,G,ROUTT,3082654008,735,244,979,680,69.46,
2012,G,ROUTT,3082654009,659,200,859,614,71.48,
2012,G,ROUTT,3082654010,421,93,514,394,76.65,
2012,G,ROUTT,3082654011,1055,423,1478,931,62.99,
2012,G,ROUTT,3082654012,654,182,836,601,71.89,
2012,G,ROUTT,3082654013,979,314,1293,878,67.9,
2012,G,ROUTT,3082654014,846,198,1044,762,72.99,
2012,G,ROUTT,3082654015,1191,317,1508,1089,72.21,
2012,G,ROUTT,3082654016,1004,291,1295,896,69.19,
2012,G,ROUTT,3082654017,975,396,1371,852,62.14,
2012,G,ROUTT,3082654018,1145,423,1568,1014,64.67,
2012,G,SAGUACHE,3356255001,864,270,1134,797,70.28,
2012,G,SAGUACHE,3356255002,94,25,119,89,74.79,
2012,G,SAGUACHE,3356255003,228,90,318,202,63.52,
2012,G,SAGUACHE,3356255004,185,75,260,174,66.92,
2012,G,SAGUACHE,3356255005,738,196,934,681,72.91,
2012,G,SAGUACHE,3356255006,557,236,793,530,66.83,
2012,G,SAGUACHE,3356255007,540,216,756,511,67.59,
2012,G,SAN JUAN,3065956001,576,84,660,523,79.24,
2012,G,SAN MIGUEL,3065857001,1638,820,2458,1500,61.03,
2012,G,SAN MIGUEL,3065857002,1039,392,1431,994,69.46,
2012,G,SAN MIGUEL,3065857003,527,212,739,503,68.06,
2012,G,SAN MIGUEL,3065857004,768,280,1048,760,72.52,
2012,G,SAN MIGUEL,3065857005,91,26,117,80,68.38,
2012,G,SAN MIGUEL,3065857006,473,359,832,444,53.37,
2012,G,SEDGWICK,4016558001,367,46,413,337,81.6,
2012,G,SEDGWICK,4016558002,297,49,346,274,79.19,
2012,G,SEDGWICK,4016558003,337,44,381,323,84.78,
2012,G,SEDGWICK,4016558004,217,32,249,195,78.31,
2012,G,SEDGWICK,4016558005,256,39,295,236,80,
2012,G,SUMMIT,2086159001,1121,802,1923,1033,53.72,
2012,G,SUMMIT,2086159002,1091,638,1729,971,56.16,
2012,G,SUMMIT,2086159003,634,363,997,598,59.98,
2012,G,SUMMIT,2086159004,1176,544,1720,1092,63.49,
2012,G,SUMMIT,2086159005,1192,488,1680,1113,66.25,
2012,G,SUMMIT,2086159006,548,235,783,519,66.28,
2012,G,SUMMIT,2086159007,698,458,1156,604,52.25,
2012,G,SUMMIT,2086159008,470,292,762,423,55.51,
2012,G,SUMMIT,2086159009,1032,612,1644,913,55.54,
2012,G,SUMMIT,2086159010,770,297,1067,721,67.57,
2012,G,SUMMIT,2086159011,537,214,751,487,64.85,
2012,G,SUMMIT,2086159012,281,103,384,270,70.31,
2012,G,SUMMIT,2086159013,904,286,1190,859,72.18,
2012,G,SUMMIT,2086159014,579,453,1032,518,50.19,
2012,G,SUMMIT,2086159015,910,373,1283,843,65.71,
2012,G,SUMMIT,2086159016,754,420,1174,698,59.45,
2012,G,SUMMIT,2086159017,968,555,1523,877,57.58,
2012,G,SUMMIT,2086159018,1056,762,1818,986,54.24,
2012,G,SUMMIT,2086159019,997,491,1488,928,62.37,
2012,G,SUMMIT,2086159020,825,556,1381,746,54.02,
2012,G,TELLER,5023960001,1261,477,1738,1203,69.22,
2012,G,TELLER,5023960002,1161,417,1578,1144,72.5,
2012,G,TELLER,5023960003,1246,493,1739,1185,68.14,
2012,G,TELLER,5023960004,1287,532,1819,1242,68.28,
2012,G,TELLER,5023960005,687,228,915,635,69.4,
2012,G,TELLER,5023960006,333,218,551,306,55.54,
2012,G,TELLER,5023960007,1412,564,1976,1325,67.05,
2012,G,TELLER,5023960008,1356,422,1778,1309,73.62,
2012,G,TELLER,5023960009,1326,366,1692,1254,74.11,
2012,G,TELLER,5023960010,1072,430,1502,1005,66.91,
2012,G,TELLER,5023960011,1450,656,2106,1382,65.62,
2012,G,TELLER,5023960012,930,410,1340,903,67.39,
2012,G,TELLER,5023960013,684,513,1197,629,52.55,
2012,G,WASHINGTON,4016461001,109,25,134,109,81.34,
2012,G,WASHINGTON,4016461002,1357,324,1681,1301,77.39,
2012,G,WASHINGTON,4016461003,149,22,171,142,83.04,
2012,G,WASHINGTON,4016461004,505,109,614,489,79.64,
2012,G,WASHINGTON,4016461005,228,40,268,222,82.84,
2012,G,WASHINGTON,4016461006,367,72,439,360,82,
2012,G,WELD,4014862118,1956,375,2331,1827,78.38,
2012,G,WELD,4014862119,615,175,790,569,72.03,
2012,G,WELD,4014862126,1090,287,1377,1006,73.06,
2012,G,WELD,4014862127,821,301,1122,754,67.2,
2012,G,WELD,4014862128,1371,236,1607,1282,79.78,
2012,G,WELD,4014862316,681,140,821,626,76.25,
2012,G,WELD,4016362100,966,248,1214,871,71.75,
2012,G,WELD,4016362101,342,74,416,316,75.96,
2012,G,WELD,4016362102,274,42,316,249,78.8,
2012,G,WELD,4016362103,351,76,427,325,76.11,
2012,G,WELD,4016362104,1528,330,1858,1420,76.43,
2012,G,WELD,4016362308,1554,397,1951,1416,72.58,
2012,G,WELD,4016362310,1394,464,1858,1282,69,
2012,G,WELD,4016362311,1457,395,1852,1337,72.19,
2012,G,WELD,4016362312,392,83,475,367,77.26,
2012,G,WELD,4016362314,2079,732,2811,1859,66.13,
2012,G,WELD,4134862120,475,97,572,445,77.8,
2012,G,WELD,4134862124,1448,365,1813,1341,73.97,
2012,G,WELD,4134862125,1179,210,1389,1113,80.13,
2012,G,WELD,4134862135,949,187,1136,904,79.58,
2012,G,WELD,4134862136,1047,264,1311,972,74.14,
2012,G,WELD,4134862146,387,210,597,345,57.79,
2012,G,WELD,4134862201,1445,443,1888,1343,71.13,
2012,G,WELD,4134862212,1237,344,1581,1150,72.74,
2012,G,WELD,4134862213,1315,283,1598,1214,75.97,
2012,G,WELD,4134862214,1316,150,1466,1274,86.9,
2012,G,WELD,4134862215,1114,158,1272,1058,83.18,
2012,G,WELD,4134862217,1414,426,1840,1288,70,
2012,G,WELD,4134862221,1066,239,1305,995,76.25,
2012,G,WELD,4134862222,1237,214,1451,1183,81.53,
2012,G,WELD,4134862223,1188,171,1359,1102,81.09,
2012,G,WELD,4134862224,624,146,770,575,74.68,
2012,G,WELD,4134862226,1772,699,2471,1622,65.64,
2012,G,WELD,4134862228,1154,430,1584,1023,64.58,
2012,G,WELD,4134862235,1255,229,1484,1189,80.12,
2012,G,WELD,4134862238,1028,362,1390,960,69.06,
2012,G,WELD,4134862241,745,183,928,680,73.28,
2012,G,WELD,4134862243,1789,402,2191,1703,77.73,
2012,G,WELD,4134862246,931,352,1283,827,64.46,
2012,G,WELD,4134862326,915,276,1191,854,71.7,
2012,G,WELD,4134862331,1031,258,1289,944,73.24,
2012,G,WELD,4134862333,616,204,820,527,64.27,
2012,G,WELD,4134862338,89,25,114,77,67.54,
2012,G,WELD,4134962145,16,3,19,13,68.42,
2012,G,WELD,4135062106,1010,484,1494,861,57.63,
2012,G,WELD,4135062107,2022,1015,3037,1590,52.35,
2012,G,WELD,4135062108,1199,502,1701,1023,60.14,
2012,G,WELD,4135062109,1313,540,1853,1155,62.33,
2012,G,WELD,4135062110,1136,750,1886,933,49.47,
2012,G,WELD,4135062111,1132,429,1561,995,63.74,
2012,G,WELD,4135062112,2085,1458,3543,1712,48.32,
2012,G,WELD,4135062114,930,239,1169,858,73.4,
2012,G,WELD,4135062132,953,204,1157,877,75.8,
2012,G,WELD,4135062137,1565,871,2436,1302,53.45,
2012,G,WELD,4135062211,1045,401,1446,943,65.21,
2012,G,WELD,4135062220,1532,510,2042,1372,67.19,
2012,G,WELD,4135062236,1264,350,1614,1175,72.8,
2012,G,WELD,4135062249,772,251,1023,710,69.4,
2012,G,WELD,4135062317,1399,871,2270,1205,53.08,
2012,G,WELD,4135062318,777,265,1042,688,66.03,
2012,G,WELD,4135062319,1017,485,1502,877,58.39,
2012,G,WELD,4135062321,946,609,1555,785,50.48,
2012,G,WELD,4135062322,1191,519,1710,1011,59.12,
2012,G,WELD,4135062323,1153,435,1588,998,62.85,
2012,G,WELD,4135062324,2007,862,2869,1733,60.4,
2012,G,WELD,4135062325,1040,509,1549,873,56.36,
2012,G,WELD,4135062330,1354,540,1894,1238,65.36,
2012,G,WELD,4136362202,354,74,428,323,75.47,
2012,G,WELD,4136362300,987,346,1333,909,68.19,
2012,G,WELD,4136362301,1112,371,1483,962,64.87,
2012,G,WELD,4136362302,1085,447,1532,946,61.75,
2012,G,WELD,4136362303,745,203,948,663,69.94,
2012,G,WELD,4136362304,1007,282,1289,918,71.22,
2012,G,WELD,4136362313,502,116,618,461,74.6,
2012,G,WELD,4234862117,906,133,1039,851,81.91,
2012,G,WELD,4234862131,718,131,849,687,80.92,
2012,G,WELD,4234862138,1351,283,1634,1267,77.54,
2012,G,WELD,4234862230,1377,301,1678,1283,76.46,
2012,G,WELD,4234862232,1203,360,1563,1113,71.21,
2012,G,WELD,4234862244,1735,399,2134,1561,73.15,
2012,G,WELD,4234862245,1210,205,1415,1133,80.07,
2012,G,WELD,4234962115,1777,293,2070,1650,79.71,
2012,G,WELD,4234962116,887,239,1126,834,74.07,
2012,G,WELD,4234962121,1641,300,1941,1549,79.8,
2012,G,WELD,4234962122,1290,369,1659,1182,71.25,
2012,G,WELD,4234962123,1186,348,1534,1107,72.16,
2012,G,WELD,4234962129,124,21,145,124,85.52,
2012,G,WELD,4234962130,1768,345,2113,1684,79.7,
2012,G,WELD,4234962143,738,124,862,696,80.74,
2012,G,WELD,4234962229,930,169,1099,878,79.89,
2012,G,WELD,4234962231,305,39,344,279,81.1,
2012,G,WELD,4236362200,1904,358,2262,1767,78.12,
2012,G,WELD,4236362203,1652,565,2217,1518,68.47,
2012,G,WELD,4236362204,1277,262,1539,1202,78.1,
2012,G,WELD,4236362205,1351,502,1853,1213,65.46,
2012,G,WELD,4236362207,1758,389,2147,1646,76.67,
2012,G,WELD,4236362208,823,148,971,796,81.98,
2012,G,WELD,4236362237,1878,401,2279,1732,76,
2012,G,WELD,4236362239,1454,385,1839,1385,75.31,
2012,G,WELD,4236362240,2376,485,2861,2212,77.32,
2012,G,WELD,4236362242,1213,402,1615,1144,70.84,
2012,G,WELD,4236362305,1545,439,1984,1380,69.56,
2012,G,WELD,4236362306,958,273,1231,898,72.95,
2012,G,WELD,4236362307,1445,219,1664,1329,79.87,
2012,G,WELD,4236362315,0,7,7,0,0,
2012,G,WELD,4236362328,1805,406,2211,1706,77.16,
2012,G,WELD,4236362334,1873,354,2227,1755,78.81,
2012,G,WELD,4236362335,1085,179,1264,1030,81.49,
2012,G,WELD,4236362337,1583,413,1996,1441,72.19,
2012,G,YUMA,4016563001,368,153,521,354,67.95,
2012,G,YUMA,4016563002,387,148,535,369,68.97,
2012,G,YUMA,4016563003,182,81,263,168,63.88,
2012,G,YUMA,4016563004,653,183,836,617,73.8,
2012,G,YUMA,4016563005,169,43,212,158,74.53,
2012,G,YUMA,4016563006,514,127,641,487,75.98,
2012,G,YUMA,4016563007,119,43,162,118,72.84,
2012,G,YUMA,4016563008,172,40,212,169,79.72,
2012,G,YUMA,4016563009,292,48,340,268,78.82,
2012,G,YUMA,4016563010,301,58,359,287,79.94,
2012,G,YUMA,4016563011,434,134,568,379,66.73,
2012,G,YUMA,4016563012,446,148,594,424,71.38,
2012,G,YUMA,4016563013,437,144,581,416,71.6,
2012,G,YUMA,4016563014,404,148,552,364,65.94,
