Year,Election Type,County,Precinct,Active Voters,Inactive Voters,Total Voters,Ballots Cast,Total Voters Turnout %
2016,G,ADAMS,4253001245,379,22,401,339,84.54
2016,G,ADAMS,4255601241,43,10,53,31,58.49
2016,G,ADAMS,4255601246,1123,160,1283,948,73.89
2016,G,ADAMS,4255601247,938,60,998,840,84.17
2016,G,ADAMS,4255601248,1935,174,2109,1703,80.75
2016,G,ADAMS,4255601249,361,36,397,313,78.84
2016,G,ADAMS,6243101150,1546,102,1648,1320,80.1
2016,G,ADAMS,6243101151,1444,116,1560,1239,79.42
2016,G,ADAMS,6243101159,1232,77,1309,1086,82.96
2016,G,ADAMS,6243401075,1759,83,1842,1587,86.16
2016,G,ADAMS,6243401076,1191,107,1298,1069,82.36
2016,G,ADAMS,6243401077,725,77,802,635,79.18
2016,G,ADAMS,6245601071,821,65,886,726,81.94
2016,G,ADAMS,6245601072,267,10,277,228,82.31
2016,G,ADAMS,6245601073,1132,73,1205,1034,85.81
2016,G,ADAMS,6245601074,1081,71,1152,954,82.81
2016,G,ADAMS,6245601160,353,20,373,314,84.18
2016,G,ADAMS,6253001152,1088,106,1194,945,79.15
2016,G,ADAMS,6253001153,775,92,867,655,75.55
2016,G,ADAMS,6253001154,55,1,56,44,78.57
2016,G,ADAMS,6253001155,364,34,398,312,78.39
2016,G,ADAMS,6253001156,316,18,334,282,84.43
2016,G,ADAMS,6253001157,896,87,983,777,79.04
2016,G,ADAMS,6253001226,218,9,227,186,81.94
2016,G,ADAMS,6253001229,1870,631,2501,1159,46.34
2016,G,ADAMS,6253001230,1465,255,1720,1020,59.3
2016,G,ADAMS,6253001231,1442,279,1721,1004,58.34
2016,G,ADAMS,6253001232,1839,412,2251,1270,56.42
2016,G,ADAMS,6253001233,1363,165,1528,1044,68.32
2016,G,ADAMS,6253001234,1169,141,1310,839,64.05
2016,G,ADAMS,6253001235,796,175,971,535,55.1
2016,G,ADAMS,6253001236,1227,175,1402,934,66.62
2016,G,ADAMS,6253001237,1054,197,1251,741,59.23
2016,G,ADAMS,6253001238,1186,139,1325,915,69.06
2016,G,ADAMS,6253001239,1029,130,1159,832,71.79
2016,G,ADAMS,6253001240,1466,218,1684,1179,70.01
2016,G,ADAMS,6253001242,440,44,484,374,77.27
2016,G,ADAMS,6253001243,848,47,895,748,83.58
2016,G,ADAMS,6253101158,844,93,937,725,77.37
2016,G,ADAMS,6255601161,141,8,149,123,82.55
2016,G,ADAMS,6255601162,909,56,965,844,87.46
2016,G,ADAMS,6255601163,378,17,395,342,86.58
2016,G,ADAMS,6255601164,432,29,461,392,85.03
2016,G,ADAMS,6255601165,1091,38,1129,1052,93.18
2016,G,ADAMS,6255601166,478,23,501,419,83.63
2016,G,ADAMS,6255601167,564,31,595,507,85.21
2016,G,ADAMS,6255601168,306,12,318,279,87.74
2016,G,ADAMS,6255601169,500,19,519,432,83.24
2016,G,ADAMS,6255601170,1363,186,1549,1057,68.24
2016,G,ADAMS,6255601171,1400,107,1507,1151,76.38
2016,G,ADAMS,6255601172,261,52,313,210,67.09
2016,G,ADAMS,6255601173,96,6,102,85,83.33
2016,G,ADAMS,6255601174,427,20,447,374,83.67
2016,G,ADAMS,6255601175,1202,138,1340,1042,77.76
2016,G,ADAMS,6255601176,492,46,538,428,79.55
2016,G,ADAMS,6255601177,0,0,0,0,0
2016,G,ADAMS,6255601178,1,0,1,0,0
2016,G,ADAMS,6255601179,0,0,0,0,0
2016,G,ADAMS,6255601180,889,64,953,780,81.85
2016,G,ADAMS,6255601181,1310,170,1480,1100,74.32
2016,G,ADAMS,6255601182,639,72,711,542,76.23
2016,G,ADAMS,6255601183,242,26,268,213,79.48
2016,G,ADAMS,6255601184,286,25,311,259,83.28
2016,G,ADAMS,6255601185,538,49,587,480,81.77
2016,G,ADAMS,6255601186,1257,107,1364,1041,76.32
2016,G,ADAMS,6255601187,1137,157,1294,936,72.33
2016,G,ADAMS,6255601188,770,67,837,686,81.96
2016,G,ADAMS,6255601189,802,51,853,721,84.53
2016,G,ADAMS,6255601190,1239,99,1338,1047,78.25
2016,G,ADAMS,6255601191,1451,151,1602,1173,73.22
2016,G,ADAMS,6255601192,935,124,1059,748,70.63
2016,G,ADAMS,6255601193,1208,180,1388,962,69.31
2016,G,ADAMS,6255601194,424,31,455,359,78.9
2016,G,ADAMS,6255601195,367,29,396,334,84.34
2016,G,ADAMS,6255601196,123,35,158,87,55.06
2016,G,ADAMS,6255601197,58,17,75,50,66.67
2016,G,ADAMS,6255601198,671,31,702,585,83.33
2016,G,ADAMS,6255601227,348,15,363,310,85.4
2016,G,ADAMS,6255601228,907,54,961,805,83.77
2016,G,ADAMS,6255601244,739,48,787,655,83.23
2016,G,ADAMS,7213001130,272,34,306,225,73.53
2016,G,ADAMS,7213001140,599,43,642,469,73.05
2016,G,ADAMS,7213001141,840,133,973,681,69.99
2016,G,ADAMS,7213001199,696,81,777,605,77.86
2016,G,ADAMS,7213001200,128,5,133,118,88.72
2016,G,ADAMS,7213001201,262,23,285,232,81.4
2016,G,ADAMS,7213001202,405,35,440,353,80.23
2016,G,ADAMS,7213001203,336,20,356,300,84.27
2016,G,ADAMS,7213001204,718,82,800,614,76.75
2016,G,ADAMS,7213001205,1295,111,1406,1086,77.24
2016,G,ADAMS,7213001206,1304,103,1407,1072,76.19
2016,G,ADAMS,7213001207,677,86,763,587,76.93
2016,G,ADAMS,7213001210,1265,82,1347,1054,78.25
2016,G,ADAMS,7213001211,437,49,486,376,77.37
2016,G,ADAMS,7213001212,308,18,326,278,85.28
2016,G,ADAMS,7213001213,360,12,372,323,86.83
2016,G,ADAMS,7213001214,1022,114,1136,908,79.93
2016,G,ADAMS,7213001215,1254,185,1439,1081,75.12
2016,G,ADAMS,7213001225,220,20,240,193,80.42
2016,G,ADAMS,7213101117,1680,140,1820,1297,71.26
2016,G,ADAMS,7213101118,992,130,1122,752,67.02
2016,G,ADAMS,7213201001,1469,276,1745,1068,61.2
2016,G,ADAMS,7213201002,1506,185,1691,1184,70.02
2016,G,ADAMS,7213201003,1138,46,1184,1008,85.14
2016,G,ADAMS,7213201004,889,115,1004,670,66.73
2016,G,ADAMS,7213201005,1586,144,1730,1262,72.95
2016,G,ADAMS,7213201006,1071,159,1230,754,61.3
2016,G,ADAMS,7213201007,1288,109,1397,1027,73.51
2016,G,ADAMS,7213201008,1016,78,1094,817,74.68
2016,G,ADAMS,7213201009,900,95,995,768,77.19
2016,G,ADAMS,7213201021,1446,228,1674,1084,64.76
2016,G,ADAMS,7213201022,1442,120,1562,1109,71
2016,G,ADAMS,7213201023,1043,126,1169,814,69.63
2016,G,ADAMS,7213201119,1294,219,1513,1002,66.23
2016,G,ADAMS,7213201120,1218,148,1366,941,68.89
2016,G,ADAMS,7213201121,1129,152,1281,849,66.28
2016,G,ADAMS,7213201122,754,77,831,569,68.47
2016,G,ADAMS,7213201123,1473,201,1674,1018,60.81
2016,G,ADAMS,7213201124,1488,174,1662,1071,64.44
2016,G,ADAMS,7213201125,1819,277,2096,1304,62.21
2016,G,ADAMS,7213201126,1632,170,1802,1177,65.32
2016,G,ADAMS,7213201127,1782,218,2000,1299,64.95
2016,G,ADAMS,7213201128,1658,180,1838,1121,60.99
2016,G,ADAMS,7213201129,1451,169,1620,1037,64.01
2016,G,ADAMS,7213201208,551,50,601,460,76.54
2016,G,ADAMS,7213201209,761,71,832,629,75.6
2016,G,ADAMS,7213201216,1575,217,1792,1300,72.54
2016,G,ADAMS,7213201217,832,111,943,698,74.02
2016,G,ADAMS,7213201218,769,71,840,677,80.6
2016,G,ADAMS,7213201219,298,34,332,256,77.11
2016,G,ADAMS,7213201220,0,0,0,0,0
2016,G,ADAMS,7213201221,490,53,543,422,77.72
2016,G,ADAMS,7213201222,0,0,0,0,0
2016,G,ADAMS,7213201223,0,0,0,0,0
2016,G,ADAMS,7213201224,40,4,44,32,72.73
2016,G,ADAMS,7213401027,761,249,1010,541,53.56
2016,G,ADAMS,7213401030,1060,172,1232,761,61.77
2016,G,ADAMS,7213401035,1131,194,1325,784,59.17
2016,G,ADAMS,7213401036,769,79,848,679,80.07
2016,G,ADAMS,7213401042,1051,214,1265,829,65.53
2016,G,ADAMS,7213501010,1410,260,1670,1102,65.99
2016,G,ADAMS,7213501011,1569,204,1773,1219,68.75
2016,G,ADAMS,7213501012,1188,124,1312,972,74.09
2016,G,ADAMS,7213501013,1645,243,1888,1291,68.38
2016,G,ADAMS,7213501014,1126,120,1246,906,72.71
2016,G,ADAMS,7213501015,1389,375,1764,1021,57.88
2016,G,ADAMS,7213501016,1118,108,1226,932,76.02
2016,G,ADAMS,7213501017,985,101,1086,815,75.05
2016,G,ADAMS,7213501018,1054,157,1211,836,69.03
2016,G,ADAMS,7213501019,763,83,846,621,73.4
2016,G,ADAMS,7213501020,1145,202,1347,859,63.77
2016,G,ADAMS,7213501024,1315,130,1445,1055,73.01
2016,G,ADAMS,7213501025,1311,128,1439,1008,70.05
2016,G,ADAMS,7213501026,1622,274,1896,1246,65.72
2016,G,ADAMS,7243101078,562,63,625,476,76.16
2016,G,ADAMS,7243101079,850,46,896,768,85.71
2016,G,ADAMS,7243101085,1221,84,1305,1046,80.15
2016,G,ADAMS,7243101086,1090,65,1155,957,82.86
2016,G,ADAMS,7243101088,1183,96,1279,1060,82.88
2016,G,ADAMS,7243101089,1299,279,1578,1067,67.62
2016,G,ADAMS,7243101093,1499,201,1700,1219,71.71
2016,G,ADAMS,7243101094,1298,101,1399,1049,74.98
2016,G,ADAMS,7243101097,1158,75,1233,961,77.94
2016,G,ADAMS,7243101105,194,63,257,132,51.36
2016,G,ADAMS,7243101134,1478,189,1667,1188,71.27
2016,G,ADAMS,7243101135,1524,147,1671,1238,74.09
2016,G,ADAMS,7243101136,1090,93,1183,916,77.43
2016,G,ADAMS,7243101137,1521,121,1642,1309,79.72
2016,G,ADAMS,7243101145,1465,101,1566,1218,77.78
2016,G,ADAMS,7243101146,1146,196,1342,904,67.36
2016,G,ADAMS,7243101147,1654,161,1815,1390,76.58
2016,G,ADAMS,7243101149,1203,96,1299,1050,80.83
2016,G,ADAMS,7243401037,948,149,1097,652,59.43
2016,G,ADAMS,7243401038,1485,180,1665,1147,68.89
2016,G,ADAMS,7243401039,1065,77,1142,893,78.2
2016,G,ADAMS,7243401040,1146,116,1262,971,76.94
2016,G,ADAMS,7243401041,1079,147,1226,855,69.74
2016,G,ADAMS,7243401051,1478,142,1620,1225,75.62
2016,G,ADAMS,7243401052,1733,380,2113,1371,64.88
2016,G,ADAMS,7243401053,1224,65,1289,1054,81.77
2016,G,ADAMS,7243401080,1062,73,1135,939,82.73
2016,G,ADAMS,7243401081,1045,77,1122,895,79.77
2016,G,ADAMS,7243401082,977,72,1049,869,82.84
2016,G,ADAMS,7243401083,1230,179,1409,1043,74.02
2016,G,ADAMS,7243401084,716,61,777,628,80.82
2016,G,ADAMS,7243401087,1241,375,1616,1010,62.5
2016,G,ADAMS,7243401090,1381,350,1731,1044,60.31
2016,G,ADAMS,7243401091,1278,243,1521,925,60.82
2016,G,ADAMS,7243401092,1407,151,1558,1155,74.13
2016,G,ADAMS,7243401095,1313,119,1432,1061,74.09
2016,G,ADAMS,7243401096,1133,76,1209,929,76.84
2016,G,ADAMS,7243401098,1103,87,1190,908,76.3
2016,G,ADAMS,7243401099,789,89,878,645,73.46
2016,G,ADAMS,7243401100,1358,199,1557,1090,70.01
2016,G,ADAMS,7243401101,1204,168,1372,981,71.5
2016,G,ADAMS,7243401102,1176,93,1269,962,75.81
2016,G,ADAMS,7243401103,556,215,771,429,55.64
2016,G,ADAMS,7243401104,1066,103,1169,886,75.79
2016,G,ADAMS,7243501031,1350,133,1483,1096,73.9
2016,G,ADAMS,7243501032,1101,97,1198,889,74.21
2016,G,ADAMS,7243501033,1524,220,1744,1279,73.34
2016,G,ADAMS,7243501034,1216,116,1332,971,72.9
2016,G,ADAMS,7243501043,1000,56,1056,920,87.12
2016,G,ADAMS,7243501044,1004,172,1176,854,72.62
2016,G,ADAMS,7243501045,758,42,800,673,84.13
2016,G,ADAMS,7243501046,771,36,807,714,88.48
2016,G,ADAMS,7243501047,1141,75,1216,1021,83.96
2016,G,ADAMS,7243501048,856,59,915,790,86.34
2016,G,ADAMS,7243501049,1136,122,1258,985,78.3
2016,G,ADAMS,7243501050,988,135,1123,852,75.87
2016,G,ADAMS,7243501054,850,80,930,761,81.83
2016,G,ADAMS,7243501055,827,114,941,734,78
2016,G,ADAMS,7243501056,1178,97,1275,1044,81.88
2016,G,ADAMS,7243501057,955,75,1030,826,80.19
2016,G,ADAMS,7243501058,1079,170,1249,962,77.02
2016,G,ADAMS,7243501059,1073,75,1148,965,84.06
2016,G,ADAMS,7243501060,1065,193,1258,909,72.26
2016,G,ADAMS,7243501061,1408,246,1654,1186,71.7
2016,G,ADAMS,7243501062,938,91,1029,853,82.9
2016,G,ADAMS,7243501063,915,53,968,830,85.74
2016,G,ADAMS,7243501064,1439,385,1824,1159,63.54
2016,G,ADAMS,7243501065,1018,79,1097,911,83.04
2016,G,ADAMS,7243501066,336,70,406,242,59.61
2016,G,ADAMS,7243501067,627,77,704,527,74.86
2016,G,ADAMS,7243501068,1285,135,1420,1088,76.62
2016,G,ADAMS,7243501069,1221,106,1327,1068,80.48
2016,G,ADAMS,7243501070,958,58,1016,859,84.55
2016,G,ADAMS,7253001131,790,94,884,570,64.48
2016,G,ADAMS,7253001132,1121,132,1253,845,67.44
2016,G,ADAMS,7253001138,827,85,912,693,75.99
2016,G,ADAMS,7253001139,216,14,230,199,86.52
2016,G,ADAMS,7253001142,906,49,955,789,82.62
2016,G,ADAMS,7253001143,771,73,844,640,75.83
2016,G,ADAMS,7253001144,1431,113,1544,1211,78.43
2016,G,ADAMS,7253001148,941,112,1053,795,75.5
2016,G,ADAMS,7253101106,1665,335,2000,1342,67.1
2016,G,ADAMS,7253101107,1264,103,1367,1029,75.27
2016,G,ADAMS,7253101108,1427,167,1594,1105,69.32
2016,G,ADAMS,7253101109,1253,109,1362,1000,73.42
2016,G,ADAMS,7253101110,950,83,1033,725,70.18
2016,G,ADAMS,7253101111,1214,122,1336,969,72.53
2016,G,ADAMS,7253101112,2035,582,2617,1464,55.94
2016,G,ADAMS,7253101113,1252,107,1359,1010,74.32
2016,G,ADAMS,7253101114,1038,154,1192,830,69.63
2016,G,ADAMS,7253101115,1130,121,1251,875,69.94
2016,G,ADAMS,7253101116,680,122,802,501,62.47
2016,G,ADAMS,7253101133,1335,136,1471,1076,73.15
2016,G,ADAMS,7253401028,944,182,1126,741,65.81
2016,G,ADAMS,7253401029,1392,313,1705,1021,59.88
2016,G,ALAMOSA,3356202001,766,167,933,644,69.02
2016,G,ALAMOSA,3356202002,937,274,1211,753,62.18
2016,G,ALAMOSA,3356202003,1500,238,1738,1295,74.51
2016,G,ALAMOSA,3356202004,1613,172,1785,1394,78.1
2016,G,ALAMOSA,3356202005,671,93,764,592,77.49
2016,G,ALAMOSA,3356202006,870,185,1055,684,64.83
2016,G,ALAMOSA,3356202007,1438,298,1736,1123,64.69
2016,G,ALAMOSA,3356202008,755,62,817,674,82.5
2016,G,ARAPAHOE,1260303101,1259,204,1463,970,66.3
2016,G,ARAPAHOE,1260303102,1175,244,1419,908,63.99
2016,G,ARAPAHOE,1260303103,692,117,809,522,64.52
2016,G,ARAPAHOE,1260303104,651,75,726,481,66.25
2016,G,ARAPAHOE,1260303105,1180,154,1334,971,72.79
2016,G,ARAPAHOE,1260303106,548,149,697,428,61.41
2016,G,ARAPAHOE,1260303107,829,139,968,715,73.86
2016,G,ARAPAHOE,1260303108,704,55,759,640,84.32
2016,G,ARAPAHOE,1260303109,668,56,724,599,82.73
2016,G,ARAPAHOE,1260303110,498,20,518,460,88.8
2016,G,ARAPAHOE,1260303111,1306,264,1570,1069,68.09
2016,G,ARAPAHOE,1260303112,887,115,1002,791,78.94
2016,G,ARAPAHOE,1260303113,656,25,681,593,87.08
2016,G,ARAPAHOE,1260303114,883,344,1227,689,56.15
2016,G,ARAPAHOE,1260303115,1054,174,1228,881,71.74
2016,G,ARAPAHOE,1260303116,1275,147,1422,1052,73.98
2016,G,ARAPAHOE,1260303117,1041,204,1245,812,65.22
2016,G,ARAPAHOE,1260303118,818,121,939,700,74.55
2016,G,ARAPAHOE,1260303119,820,81,901,679,75.36
2016,G,ARAPAHOE,1260303120,572,46,618,482,77.99
2016,G,ARAPAHOE,1260303121,581,66,647,523,80.83
2016,G,ARAPAHOE,1260303122,767,69,836,599,71.65
2016,G,ARAPAHOE,1260303123,916,119,1035,773,74.69
2016,G,ARAPAHOE,1260303124,1121,176,1297,902,69.55
2016,G,ARAPAHOE,1260303125,622,247,869,474,54.55
2016,G,ARAPAHOE,1260303129,633,56,689,557,80.84
2016,G,ARAPAHOE,1260303130,1001,101,1102,856,77.68
2016,G,ARAPAHOE,1260303131,1036,73,1109,925,83.41
2016,G,ARAPAHOE,1260303132,1049,60,1109,961,86.65
2016,G,ARAPAHOE,1260303133,1032,72,1104,926,83.88
2016,G,ARAPAHOE,1260303134,569,30,599,514,85.81
2016,G,ARAPAHOE,1260303135,382,23,405,346,85.43
2016,G,ARAPAHOE,1260303136,848,31,879,789,89.76
2016,G,ARAPAHOE,1260303140,469,50,519,398,76.69
2016,G,ARAPAHOE,1263803141,475,10,485,440,90.72
2016,G,ARAPAHOE,1310903137,896,51,947,806,85.11
2016,G,ARAPAHOE,1310903138,425,19,444,386,86.94
2016,G,ARAPAHOE,1310903139,708,57,765,628,82.09
2016,G,ARAPAHOE,1310903230,0,0,0,0,0
2016,G,ARAPAHOE,1310903402,0,0,0,0,0
2016,G,ARAPAHOE,1310903475,32,0,32,28,87.5
2016,G,ARAPAHOE,1310903501,1229,348,1577,1018,64.55
2016,G,ARAPAHOE,1310903502,1300,471,1771,1007,56.86
2016,G,ARAPAHOE,4283603348,0,0,0,0,0
2016,G,ARAPAHOE,4283603350,3,0,3,0,0
2016,G,ARAPAHOE,4293603358,29,16,45,24,53.33
2016,G,ARAPAHOE,4293603361,1,1,2,0,0
2016,G,ARAPAHOE,4295603357,2,0,2,0,0
2016,G,ARAPAHOE,4295603359,0,0,0,0,0
2016,G,ARAPAHOE,4295603362,1102,77,1179,974,82.61
2016,G,ARAPAHOE,4295603363,1089,96,1185,959,80.93
2016,G,ARAPAHOE,4295603364,1307,153,1460,1126,77.12
2016,G,ARAPAHOE,4295603365,595,67,662,504,76.13
2016,G,ARAPAHOE,4295603366,855,77,932,763,81.87
2016,G,ARAPAHOE,6260303126,734,235,969,540,55.73
2016,G,ARAPAHOE,6260303127,112,35,147,84,57.14
2016,G,ARAPAHOE,6260303128,443,32,475,381,80.21
2016,G,ARAPAHOE,6260303143,766,143,909,631,69.42
2016,G,ARAPAHOE,6260303153,1342,303,1645,1138,69.18
2016,G,ARAPAHOE,6260303161,742,82,824,641,77.79
2016,G,ARAPAHOE,6260303162,849,224,1073,696,64.86
2016,G,ARAPAHOE,6260303201,389,18,407,344,84.52
2016,G,ARAPAHOE,6260303202,360,16,376,319,84.84
2016,G,ARAPAHOE,6260303203,790,43,833,717,86.07
2016,G,ARAPAHOE,6260303204,1616,92,1708,1469,86.01
2016,G,ARAPAHOE,6260303229,1186,72,1258,1066,84.74
2016,G,ARAPAHOE,6260303231,2109,594,2703,1738,64.3
2016,G,ARAPAHOE,6260303232,1515,66,1581,1388,87.79
2016,G,ARAPAHOE,6260303234,376,151,527,311,59.01
2016,G,ARAPAHOE,6260303249,825,76,901,778,86.35
2016,G,ARAPAHOE,6260303253,1573,127,1700,1409,82.88
2016,G,ARAPAHOE,6260303254,422,25,447,385,86.13
2016,G,ARAPAHOE,6260303256,0,0,0,0,0
2016,G,ARAPAHOE,6263803142,925,60,985,834,84.67
2016,G,ARAPAHOE,6263803144,791,53,844,705,83.53
2016,G,ARAPAHOE,6263803145,684,87,771,584,75.75
2016,G,ARAPAHOE,6263803146,819,31,850,742,87.29
2016,G,ARAPAHOE,6263803147,888,66,954,822,86.16
2016,G,ARAPAHOE,6263803148,588,26,614,542,88.27
2016,G,ARAPAHOE,6263803149,1179,55,1234,1092,88.49
2016,G,ARAPAHOE,6263803150,1250,190,1440,1087,75.49
2016,G,ARAPAHOE,6263803151,851,248,1099,717,65.24
2016,G,ARAPAHOE,6263803152,834,87,921,770,83.6
2016,G,ARAPAHOE,6263803154,1066,145,1211,914,75.47
2016,G,ARAPAHOE,6263803155,1232,50,1282,1113,86.82
2016,G,ARAPAHOE,6263803156,484,13,497,450,90.54
2016,G,ARAPAHOE,6263803157,652,23,675,614,90.96
2016,G,ARAPAHOE,6263803158,911,88,999,811,81.18
2016,G,ARAPAHOE,6263803159,713,123,836,626,74.88
2016,G,ARAPAHOE,6263803160,923,134,1057,782,73.98
2016,G,ARAPAHOE,6263803163,792,114,906,699,77.15
2016,G,ARAPAHOE,6263803165,1034,73,1107,922,83.29
2016,G,ARAPAHOE,6263803166,446,20,466,406,87.12
2016,G,ARAPAHOE,6263803167,932,102,1034,787,76.11
2016,G,ARAPAHOE,6263803168,929,48,977,868,88.84
2016,G,ARAPAHOE,6263803169,1047,76,1123,947,84.33
2016,G,ARAPAHOE,6263803170,1249,247,1496,1089,72.79
2016,G,ARAPAHOE,6263803171,790,42,832,724,87.02
2016,G,ARAPAHOE,6263803172,798,60,858,727,84.73
2016,G,ARAPAHOE,6263803173,1474,145,1619,1292,79.8
2016,G,ARAPAHOE,6263803174,1003,78,1081,893,82.61
2016,G,ARAPAHOE,6263803175,800,55,855,739,86.43
2016,G,ARAPAHOE,6263803176,964,110,1074,849,79.05
2016,G,ARAPAHOE,6264003255,1091,280,1371,908,66.23
2016,G,ARAPAHOE,6264003258,345,135,480,263,54.79
2016,G,ARAPAHOE,6264003323,36,2,38,31,81.58
2016,G,ARAPAHOE,6264003424,0,0,0,0,0
2016,G,ARAPAHOE,6264003453,563,43,606,508,83.83
2016,G,ARAPAHOE,6264003455,401,39,440,359,81.59
2016,G,ARAPAHOE,6264103401,1270,300,1570,1018,64.84
2016,G,ARAPAHOE,6264103403,787,335,1122,618,55.08
2016,G,ARAPAHOE,6264103404,418,160,578,294,50.87
2016,G,ARAPAHOE,6264103405,937,279,1216,717,58.96
2016,G,ARAPAHOE,6264103406,495,131,626,384,61.34
2016,G,ARAPAHOE,6264103407,1897,459,2356,1559,66.17
2016,G,ARAPAHOE,6264103408,2010,406,2416,1649,68.25
2016,G,ARAPAHOE,6264103409,929,319,1248,726,58.17
2016,G,ARAPAHOE,6264103410,1058,140,1198,913,76.21
2016,G,ARAPAHOE,6264103411,1403,496,1899,1098,57.82
2016,G,ARAPAHOE,6264103412,678,95,773,563,72.83
2016,G,ARAPAHOE,6264103413,1117,389,1506,875,58.1
2016,G,ARAPAHOE,6264103414,919,166,1085,761,70.14
2016,G,ARAPAHOE,6264103415,0,0,0,0,0
2016,G,ARAPAHOE,6264103416,1545,199,1744,1263,72.42
2016,G,ARAPAHOE,6264103417,1061,191,1252,871,69.57
2016,G,ARAPAHOE,6264103418,911,63,974,772,79.26
2016,G,ARAPAHOE,6264103419,1008,91,1099,858,78.07
2016,G,ARAPAHOE,6264103423,1353,173,1526,1178,77.2
2016,G,ARAPAHOE,6264103425,1258,162,1420,1068,75.21
2016,G,ARAPAHOE,6264103426,717,74,791,635,80.28
2016,G,ARAPAHOE,6264103442,755,58,813,686,84.38
2016,G,ARAPAHOE,6264103443,547,33,580,516,88.97
2016,G,ARAPAHOE,6270303245,499,27,526,468,88.97
2016,G,ARAPAHOE,6270303246,1047,114,1161,938,80.79
2016,G,ARAPAHOE,6270303247,1552,253,1805,1337,74.07
2016,G,ARAPAHOE,6270303248,651,116,767,570,74.32
2016,G,ARAPAHOE,6270303250,1026,66,1092,931,85.26
2016,G,ARAPAHOE,6270303251,1422,126,1548,1310,84.63
2016,G,ARAPAHOE,6270303252,1417,80,1497,1287,85.97
2016,G,ARAPAHOE,6273603335,1506,135,1641,1250,76.17
2016,G,ARAPAHOE,6273603336,1431,173,1604,1203,75
2016,G,ARAPAHOE,6273603337,1342,199,1541,1118,72.55
2016,G,ARAPAHOE,6273603368,673,169,842,523,62.11
2016,G,ARAPAHOE,6273703218,842,156,998,740,74.15
2016,G,ARAPAHOE,6273703220,895,65,960,817,85.1
2016,G,ARAPAHOE,6273703221,804,42,846,737,87.12
2016,G,ARAPAHOE,6273703222,899,52,951,834,87.7
2016,G,ARAPAHOE,6273703223,926,143,1069,822,76.89
2016,G,ARAPAHOE,6273703224,873,85,958,790,82.46
2016,G,ARAPAHOE,6273703225,956,62,1018,878,86.25
2016,G,ARAPAHOE,6273703226,682,53,735,621,84.49
2016,G,ARAPAHOE,6273703227,700,45,745,628,84.3
2016,G,ARAPAHOE,6273703228,714,47,761,639,83.97
2016,G,ARAPAHOE,6273703233,787,214,1001,657,65.63
2016,G,ARAPAHOE,6273703235,709,65,774,628,81.14
2016,G,ARAPAHOE,6273703236,667,80,747,599,80.19
2016,G,ARAPAHOE,6273703237,1166,86,1252,1036,82.75
2016,G,ARAPAHOE,6273703238,833,120,953,737,77.33
2016,G,ARAPAHOE,6273703239,893,59,952,810,85.08
2016,G,ARAPAHOE,6273703240,1318,116,1434,1221,85.15
2016,G,ARAPAHOE,6273703241,1005,92,1097,907,82.68
2016,G,ARAPAHOE,6273703242,745,52,797,693,86.95
2016,G,ARAPAHOE,6273703243,2177,603,2780,1748,62.88
2016,G,ARAPAHOE,6273703244,976,120,1096,853,77.83
2016,G,ARAPAHOE,6273703257,1157,90,1247,1008,80.83
2016,G,ARAPAHOE,6273703259,1733,519,2252,1333,59.19
2016,G,ARAPAHOE,6273703260,1535,288,1823,1280,70.21
2016,G,ARAPAHOE,6273703261,1352,120,1472,1190,80.84
2016,G,ARAPAHOE,6273703262,1300,102,1402,1142,81.46
2016,G,ARAPAHOE,6273703263,1024,76,1100,897,81.55
2016,G,ARAPAHOE,6273703264,1213,120,1333,1064,79.82
2016,G,ARAPAHOE,6273703274,1119,110,1229,1006,81.86
2016,G,ARAPAHOE,6273703275,644,64,708,535,75.56
2016,G,ARAPAHOE,6273703276,310,41,351,249,70.94
2016,G,ARAPAHOE,6273703277,871,88,959,735,76.64
2016,G,ARAPAHOE,6273703278,513,36,549,438,79.78
2016,G,ARAPAHOE,6273703279,926,91,1017,915,89.97
2016,G,ARAPAHOE,6273703280,1166,85,1251,1006,80.42
2016,G,ARAPAHOE,6273703281,1162,106,1268,1001,78.94
2016,G,ARAPAHOE,6273703282,1391,125,1516,1188,78.36
2016,G,ARAPAHOE,6273703283,874,86,960,755,78.65
2016,G,ARAPAHOE,6273703284,706,205,911,563,61.8
2016,G,ARAPAHOE,6273703285,716,60,776,639,82.35
2016,G,ARAPAHOE,6273703320,1536,170,1706,1278,74.91
2016,G,ARAPAHOE,6273703321,1290,110,1400,1152,82.29
2016,G,ARAPAHOE,6273703322,1156,70,1226,1018,83.03
2016,G,ARAPAHOE,6273703324,588,29,617,534,86.55
2016,G,ARAPAHOE,6273703325,1662,95,1757,1505,85.66
2016,G,ARAPAHOE,6273703328,292,23,315,263,83.49
2016,G,ARAPAHOE,6273703331,657,70,727,584,80.33
2016,G,ARAPAHOE,6273703332,1065,106,1171,896,76.52
2016,G,ARAPAHOE,6273703333,766,98,864,626,72.45
2016,G,ARAPAHOE,6273703334,1788,240,2028,1527,75.3
2016,G,ARAPAHOE,6273703338,965,120,1085,804,74.1
2016,G,ARAPAHOE,6273703339,1249,136,1385,1050,75.81
2016,G,ARAPAHOE,6273703367,1201,82,1283,1068,83.24
2016,G,ARAPAHOE,6273703458,0,0,0,0,0
2016,G,ARAPAHOE,6273803164,787,61,848,688,81.13
2016,G,ARAPAHOE,6273803177,964,57,1021,846,82.86
2016,G,ARAPAHOE,6273803178,811,87,898,680,75.72
2016,G,ARAPAHOE,6273803179,714,51,765,616,80.52
2016,G,ARAPAHOE,6273803180,774,40,814,724,88.94
2016,G,ARAPAHOE,6273803181,670,87,757,596,78.73
2016,G,ARAPAHOE,6273803182,937,56,993,845,85.1
2016,G,ARAPAHOE,6273803183,1305,138,1443,1134,78.59
2016,G,ARAPAHOE,6273803184,717,36,753,658,87.38
2016,G,ARAPAHOE,6273803185,917,99,1016,798,78.54
2016,G,ARAPAHOE,6273803186,932,63,995,861,86.53
2016,G,ARAPAHOE,6273803187,915,66,981,821,83.69
2016,G,ARAPAHOE,6273803188,645,33,678,586,86.43
2016,G,ARAPAHOE,6273803189,1081,83,1164,1001,86
2016,G,ARAPAHOE,6273803190,1188,161,1349,1041,77.17
2016,G,ARAPAHOE,6273803191,1133,64,1197,1039,86.8
2016,G,ARAPAHOE,6273803192,1034,63,1097,949,86.51
2016,G,ARAPAHOE,6273803193,850,83,933,775,83.07
2016,G,ARAPAHOE,6273803194,1161,100,1261,1047,83.03
2016,G,ARAPAHOE,6273803195,1018,34,1052,950,90.3
2016,G,ARAPAHOE,6273803196,616,31,647,568,87.79
2016,G,ARAPAHOE,6273803197,692,36,728,627,86.13
2016,G,ARAPAHOE,6273803205,672,56,728,600,82.42
2016,G,ARAPAHOE,6273803206,800,47,847,749,88.43
2016,G,ARAPAHOE,6273803207,1139,97,1236,1001,80.99
2016,G,ARAPAHOE,6273803208,1144,64,1208,1035,85.68
2016,G,ARAPAHOE,6273803209,1018,59,1077,941,87.37
2016,G,ARAPAHOE,6273803210,1537,122,1659,1350,81.37
2016,G,ARAPAHOE,6273803211,885,74,959,754,78.62
2016,G,ARAPAHOE,6273803212,1281,144,1425,1103,77.4
2016,G,ARAPAHOE,6273803213,1039,81,1120,905,80.8
2016,G,ARAPAHOE,6273803214,856,36,892,768,86.1
2016,G,ARAPAHOE,6273803215,683,36,719,628,87.34
2016,G,ARAPAHOE,6273803216,940,53,993,852,85.8
2016,G,ARAPAHOE,6273803217,844,48,892,782,87.67
2016,G,ARAPAHOE,6273803219,1162,63,1225,1068,87.18
2016,G,ARAPAHOE,6274003457,4,0,4,0,0
2016,G,ARAPAHOE,6283603340,1176,49,1225,1070,87.35
2016,G,ARAPAHOE,6283603341,2117,181,2298,1800,78.33
2016,G,ARAPAHOE,6283603342,1639,234,1873,1344,71.76
2016,G,ARAPAHOE,6283603343,1549,192,1741,1296,74.44
2016,G,ARAPAHOE,6283603344,1506,132,1638,1307,79.79
2016,G,ARAPAHOE,6283603349,0,0,0,0,0
2016,G,ARAPAHOE,6283603351,1622,174,1796,1382,76.95
2016,G,ARAPAHOE,6283603369,866,85,951,748,78.65
2016,G,ARAPAHOE,6283603370,1382,139,1521,1166,76.66
2016,G,ARAPAHOE,6283603371,903,94,997,758,76.03
2016,G,ARAPAHOE,6283603372,1646,151,1797,1420,79.02
2016,G,ARAPAHOE,6283603561,0,0,0,0,0
2016,G,ARAPAHOE,6284003265,972,171,1143,757,66.23
2016,G,ARAPAHOE,6284003266,1030,139,1169,837,71.6
2016,G,ARAPAHOE,6284003267,1029,124,1153,865,75.02
2016,G,ARAPAHOE,6284003268,810,93,903,708,78.41
2016,G,ARAPAHOE,6284003269,967,144,1111,780,70.21
2016,G,ARAPAHOE,6284003270,887,149,1036,704,67.95
2016,G,ARAPAHOE,6284003271,744,90,834,621,74.46
2016,G,ARAPAHOE,6284003272,854,78,932,744,79.83
2016,G,ARAPAHOE,6284003273,848,80,928,717,77.26
2016,G,ARAPAHOE,6284003302,1223,107,1330,1039,78.12
2016,G,ARAPAHOE,6284003303,871,96,967,758,78.39
2016,G,ARAPAHOE,6284003304,857,109,966,700,72.46
2016,G,ARAPAHOE,6284003305,1261,168,1429,1068,74.74
2016,G,ARAPAHOE,6284003306,850,72,922,708,76.79
2016,G,ARAPAHOE,6284003307,722,337,1059,520,49.1
2016,G,ARAPAHOE,6284003308,1091,136,1227,906,73.84
2016,G,ARAPAHOE,6284003309,1285,161,1446,1036,71.65
2016,G,ARAPAHOE,6284003310,1587,160,1747,1297,74.24
2016,G,ARAPAHOE,6284003311,1537,174,1711,1292,75.51
2016,G,ARAPAHOE,6284003312,1615,219,1834,1323,72.14
2016,G,ARAPAHOE,6284003313,1055,128,1183,854,72.19
2016,G,ARAPAHOE,6284003314,717,94,811,613,75.59
2016,G,ARAPAHOE,6284003315,1424,172,1596,1171,73.37
2016,G,ARAPAHOE,6284003316,735,88,823,606,73.63
2016,G,ARAPAHOE,6284003317,1014,123,1137,810,71.24
2016,G,ARAPAHOE,6284003318,840,123,963,673,69.89
2016,G,ARAPAHOE,6284003319,848,127,975,670,68.72
2016,G,ARAPAHOE,6284003446,786,74,860,680,79.07
2016,G,ARAPAHOE,6284003447,914,164,1078,715,66.33
2016,G,ARAPAHOE,6284003448,1595,306,1901,1352,71.12
2016,G,ARAPAHOE,6284003449,723,87,810,628,77.53
2016,G,ARAPAHOE,6284003450,1926,375,2301,1541,66.97
2016,G,ARAPAHOE,6284003451,494,55,549,413,75.23
2016,G,ARAPAHOE,6284003452,803,85,888,667,75.11
2016,G,ARAPAHOE,6284003454,1006,123,1129,866,76.71
2016,G,ARAPAHOE,6284003456,1138,120,1258,979,77.82
2016,G,ARAPAHOE,6284003459,820,120,940,654,69.57
2016,G,ARAPAHOE,6284003460,1025,163,1188,829,69.78
2016,G,ARAPAHOE,6284003461,1202,158,1360,1003,73.75
2016,G,ARAPAHOE,6284003462,1149,122,1271,990,77.89
2016,G,ARAPAHOE,6284003463,1404,143,1547,1166,75.37
2016,G,ARAPAHOE,6284003464,906,116,1022,739,72.31
2016,G,ARAPAHOE,6284003472,1198,354,1552,850,54.77
2016,G,ARAPAHOE,6284003473,1584,286,1870,1252,66.95
2016,G,ARAPAHOE,6284103301,637,78,715,524,73.29
2016,G,ARAPAHOE,6284103420,1604,271,1875,1307,69.71
2016,G,ARAPAHOE,6284103421,536,38,574,479,83.45
2016,G,ARAPAHOE,6284103422,664,87,751,552,73.5
2016,G,ARAPAHOE,6284103427,1433,163,1596,1239,77.63
2016,G,ARAPAHOE,6284103428,1011,137,1148,864,75.26
2016,G,ARAPAHOE,6284103429,953,238,1191,756,63.48
2016,G,ARAPAHOE,6284103430,1053,215,1268,849,66.96
2016,G,ARAPAHOE,6284103431,594,51,645,492,76.28
2016,G,ARAPAHOE,6284103432,1156,228,1384,911,65.82
2016,G,ARAPAHOE,6284103433,936,164,1100,756,68.73
2016,G,ARAPAHOE,6284103437,1290,135,1425,1048,73.54
2016,G,ARAPAHOE,6284103438,876,149,1025,740,72.2
2016,G,ARAPAHOE,6284103439,927,73,1000,788,78.8
2016,G,ARAPAHOE,6284103440,804,50,854,756,88.52
2016,G,ARAPAHOE,6284103441,828,46,874,783,89.59
2016,G,ARAPAHOE,6284103444,610,72,682,515,75.51
2016,G,ARAPAHOE,6284103445,665,103,768,555,72.27
2016,G,ARAPAHOE,6284103465,655,49,704,558,79.26
2016,G,ARAPAHOE,6284103466,857,103,960,699,72.81
2016,G,ARAPAHOE,6284103467,879,107,986,717,72.72
2016,G,ARAPAHOE,6284103468,824,82,906,647,71.41
2016,G,ARAPAHOE,6284103469,808,161,969,615,63.47
2016,G,ARAPAHOE,6284103470,1163,218,1381,912,66.04
2016,G,ARAPAHOE,6284103471,969,120,1089,768,70.52
2016,G,ARAPAHOE,6284203434,1087,185,1272,884,69.5
2016,G,ARAPAHOE,6284203435,1303,262,1565,977,62.43
2016,G,ARAPAHOE,6284203436,1351,380,1731,993,57.37
2016,G,ARAPAHOE,6285603352,2105,222,2327,1802,77.44
2016,G,ARAPAHOE,6285603373,1542,109,1651,1387,84.01
2016,G,ARAPAHOE,6293603345,350,20,370,307,82.97
2016,G,ARAPAHOE,6293603346,1248,139,1387,1079,77.79
2016,G,ARAPAHOE,6293603347,1679,120,1799,1456,80.93
2016,G,ARAPAHOE,6293603360,484,104,588,320,54.42
2016,G,ARAPAHOE,6293603374,1637,231,1868,1369,73.29
2016,G,ARAPAHOE,6293603474,680,94,774,546,70.54
2016,G,ARAPAHOE,6293603537,1083,181,1264,865,68.43
2016,G,ARAPAHOE,6293603538,1088,143,1231,856,69.54
2016,G,ARAPAHOE,6293603539,1095,231,1326,860,64.86
2016,G,ARAPAHOE,6293603540,717,59,776,571,73.58
2016,G,ARAPAHOE,6293603541,697,131,828,563,68
2016,G,ARAPAHOE,6293603542,733,424,1157,499,43.13
2016,G,ARAPAHOE,6293603543,872,132,1004,714,71.12
2016,G,ARAPAHOE,6293603544,1188,433,1621,824,50.83
2016,G,ARAPAHOE,6293603545,393,121,514,294,57.2
2016,G,ARAPAHOE,6293603546,1017,141,1158,795,68.65
2016,G,ARAPAHOE,6293603547,1032,73,1105,820,74.21
2016,G,ARAPAHOE,6293603548,498,203,701,316,45.08
2016,G,ARAPAHOE,6293603549,538,117,655,374,57.1
2016,G,ARAPAHOE,6293603550,90,7,97,66,68.04
2016,G,ARAPAHOE,6293603551,766,267,1033,572,55.37
2016,G,ARAPAHOE,6293603552,948,200,1148,648,56.45
2016,G,ARAPAHOE,6293603553,1282,279,1561,987,63.23
2016,G,ARAPAHOE,6293603554,1046,138,1184,841,71.03
2016,G,ARAPAHOE,6293603555,910,138,1048,707,67.46
2016,G,ARAPAHOE,6293603556,1200,149,1349,953,70.64
2016,G,ARAPAHOE,6293603557,1608,266,1874,1313,70.06
2016,G,ARAPAHOE,6293603558,983,107,1090,757,69.45
2016,G,ARAPAHOE,6293603559,889,110,999,705,70.57
2016,G,ARAPAHOE,6293603560,438,87,525,348,66.29
2016,G,ARAPAHOE,6294203503,1621,398,2019,1127,55.82
2016,G,ARAPAHOE,6294203504,885,146,1031,627,60.81
2016,G,ARAPAHOE,6294203505,975,271,1246,675,54.17
2016,G,ARAPAHOE,6294203506,1386,419,1805,846,46.87
2016,G,ARAPAHOE,6294203507,827,124,951,606,63.72
2016,G,ARAPAHOE,6294203508,683,92,775,486,62.71
2016,G,ARAPAHOE,6294203509,616,62,678,487,71.83
2016,G,ARAPAHOE,6294203510,645,63,708,569,80.37
2016,G,ARAPAHOE,6294203511,1073,372,1445,758,52.46
2016,G,ARAPAHOE,6294203512,994,248,1242,726,58.45
2016,G,ARAPAHOE,6294203513,941,242,1183,726,61.37
2016,G,ARAPAHOE,6294203514,757,223,980,548,55.92
2016,G,ARAPAHOE,6294203515,922,89,1011,758,74.98
2016,G,ARAPAHOE,6294203516,677,106,783,549,70.11
2016,G,ARAPAHOE,6294203517,736,112,848,564,66.51
2016,G,ARAPAHOE,6294203518,708,141,849,526,61.96
2016,G,ARAPAHOE,6294203519,752,183,935,531,56.79
2016,G,ARAPAHOE,6294203520,910,104,1014,711,70.12
2016,G,ARAPAHOE,6294203521,833,95,928,631,68
2016,G,ARAPAHOE,6294203522,997,102,1099,772,70.25
2016,G,ARAPAHOE,6294203523,1247,169,1416,979,69.14
2016,G,ARAPAHOE,6294203524,835,185,1020,616,60.39
2016,G,ARAPAHOE,6294203525,917,139,1056,650,61.55
2016,G,ARAPAHOE,6294203526,829,130,959,636,66.32
2016,G,ARAPAHOE,6294203527,1099,266,1365,792,58.02
2016,G,ARAPAHOE,6294203528,538,84,622,374,60.13
2016,G,ARAPAHOE,6294203529,334,151,485,201,41.44
2016,G,ARAPAHOE,6294203530,994,237,1231,684,55.56
2016,G,ARAPAHOE,6294203531,810,96,906,585,64.57
2016,G,ARAPAHOE,6294203532,1021,320,1341,751,56
2016,G,ARAPAHOE,6294203533,1375,370,1745,1067,61.15
2016,G,ARAPAHOE,6294203534,903,476,1379,632,45.83
2016,G,ARAPAHOE,6294203535,825,90,915,702,76.72
2016,G,ARAPAHOE,6294203536,742,324,1066,493,46.25
2016,G,ARAPAHOE,6295603326,1391,112,1503,1309,87.09
2016,G,ARAPAHOE,6295603327,1254,143,1397,1077,77.09
2016,G,ARAPAHOE,6295603329,1976,357,2333,1683,72.14
2016,G,ARAPAHOE,6295603330,1763,216,1979,1496,75.59
2016,G,ARAPAHOE,6295603353,1608,144,1752,1450,82.76
2016,G,ARAPAHOE,6295603354,1484,157,1641,1338,81.54
2016,G,ARAPAHOE,6295603355,1324,91,1415,1183,83.6
2016,G,ARAPAHOE,6295603356,291,13,304,270,88.82
2016,G,ARAPAHOE,6295603375,966,195,1161,818,70.46
2016,G,ARAPAHOE,6295603376,1337,103,1440,1248,86.67
2016,G,ARAPAHOE,6295603377,1146,68,1214,1012,83.36
2016,G,ARCHULETA,3065904001,917,133,1050,783,74.57
2016,G,ARCHULETA,3065904002,943,162,1105,794,71.86
2016,G,ARCHULETA,3065904003,738,113,851,645,75.79
2016,G,ARCHULETA,3065904004,406,63,469,332,70.79
2016,G,ARCHULETA,3065904005,547,92,639,453,70.89
2016,G,ARCHULETA,3065904006,1960,403,2363,1682,71.18
2016,G,ARCHULETA,3065904007,1565,399,1964,1311,66.75
2016,G,ARCHULETA,3065904008,1813,346,2159,1539,71.28
2016,G,BACA,4356405001,316,24,340,280,82.35
2016,G,BACA,4356405002,348,35,383,299,78.07
2016,G,BACA,4356405003,194,20,214,169,78.97
2016,G,BACA,4356405004,388,53,441,329,74.6
2016,G,BACA,4356405005,138,13,151,123,81.46
2016,G,BACA,4356405006,172,18,190,148,77.89
2016,G,BACA,4356405007,455,52,507,388,76.53
2016,G,BACA,4356405008,445,49,494,397,80.36
2016,G,BACA,4356405009,91,14,105,81,77.14
2016,G,BENT,4356406001,412,56,468,330,70.51
2016,G,BENT,4356406002,523,58,581,448,77.11
2016,G,BENT,4356406003,595,148,743,453,60.97
2016,G,BENT,4356406004,462,123,585,359,61.37
2016,G,BENT,4356406005,476,85,561,403,71.84
2016,G,BOULDER,2161307900,495,76,571,440,77.06
2016,G,BOULDER,2161307901,659,115,774,586,75.71
2016,G,BOULDER,2161307902,290,40,330,255,77.27
2016,G,BOULDER,2163307100,1295,242,1537,1174,76.38
2016,G,BOULDER,2163307101,1211,187,1398,1119,80.04
2016,G,BOULDER,2163307102,1026,692,1718,848,49.36
2016,G,BOULDER,2163307103,1119,131,1250,1030,82.4
2016,G,BOULDER,2163307104,1066,133,1199,970,80.9
2016,G,BOULDER,2163307105,476,137,613,411,67.05
2016,G,BOULDER,2163307106,991,125,1116,908,81.36
2016,G,BOULDER,2163307107,677,136,813,580,71.34
2016,G,BOULDER,2171207200,629,59,688,578,84.01
2016,G,BOULDER,2171207201,665,88,753,618,82.07
2016,G,BOULDER,2171207202,1107,214,1321,1021,77.29
2016,G,BOULDER,2171207203,985,83,1068,932,87.27
2016,G,BOULDER,2171207204,1014,143,1157,931,80.47
2016,G,BOULDER,2171207205,975,135,1110,893,80.45
2016,G,BOULDER,2171207206,535,49,584,502,85.96
2016,G,BOULDER,2171207207,971,121,1092,897,82.14
2016,G,BOULDER,2171207208,1073,139,1212,1003,82.76
2016,G,BOULDER,2171207209,615,42,657,578,87.98
2016,G,BOULDER,2171207210,930,119,1049,848,80.84
2016,G,BOULDER,2171207211,1076,166,1242,964,77.62
2016,G,BOULDER,2171207212,1068,198,1266,977,77.17
2016,G,BOULDER,2171207213,1985,154,2139,1811,84.67
2016,G,BOULDER,2171207214,1257,164,1421,1144,80.51
2016,G,BOULDER,2171207300,1448,170,1618,1313,81.15
2016,G,BOULDER,2171207301,1766,230,1996,1491,74.7
2016,G,BOULDER,2171207302,1115,196,1311,1001,76.35
2016,G,BOULDER,2171207303,923,171,1094,804,73.49
2016,G,BOULDER,2171207304,901,91,992,825,83.17
2016,G,BOULDER,2171207305,1120,227,1347,979,72.68
2016,G,BOULDER,2171207306,1148,198,1346,1022,75.93
2016,G,BOULDER,2171207307,1001,288,1289,823,63.85
2016,G,BOULDER,2171207308,963,177,1140,857,75.18
2016,G,BOULDER,2171207309,1140,154,1294,1033,79.83
2016,G,BOULDER,2171207310,1334,190,1524,1178,77.3
2016,G,BOULDER,2171207311,830,149,979,750,76.61
2016,G,BOULDER,2171207312,957,124,1081,890,82.33
2016,G,BOULDER,2171207313,1304,140,1444,1210,83.8
2016,G,BOULDER,2171207314,1250,82,1332,1165,87.46
2016,G,BOULDER,2171207315,821,144,965,760,78.76
2016,G,BOULDER,2171207316,1171,119,1290,1075,83.33
2016,G,BOULDER,2171207407,460,53,513,420,81.87
2016,G,BOULDER,2173307400,128,5,133,122,91.73
2016,G,BOULDER,2173307408,1184,156,1340,1081,80.67
2016,G,BOULDER,2173307409,1599,181,1780,1443,81.07
2016,G,BOULDER,2173307410,1103,102,1205,1009,83.73
2016,G,BOULDER,2173307411,2022,209,2231,1858,83.28
2016,G,BOULDER,2173307412,1530,167,1697,1381,81.38
2016,G,BOULDER,2181007500,912,161,1073,818,76.23
2016,G,BOULDER,2181007501,915,100,1015,846,83.35
2016,G,BOULDER,2181007502,1024,95,1119,952,85.08
2016,G,BOULDER,2181007503,1462,128,1590,1365,85.85
2016,G,BOULDER,2181007504,758,57,815,705,86.5
2016,G,BOULDER,2181007800,870,127,997,805,80.74
2016,G,BOULDER,2181007801,828,85,913,738,80.83
2016,G,BOULDER,2181007802,973,342,1315,841,63.95
2016,G,BOULDER,2181007803,973,290,1263,875,69.28
2016,G,BOULDER,2181007804,1269,150,1419,1174,82.73
2016,G,BOULDER,2181007805,476,54,530,434,81.89
2016,G,BOULDER,2181007806,1226,235,1461,1088,74.47
2016,G,BOULDER,2181007807,1148,148,1296,1048,80.86
2016,G,BOULDER,2181007808,1957,328,2285,1721,75.32
2016,G,BOULDER,2181007809,1034,148,1182,934,79.02
2016,G,BOULDER,2181007810,1057,121,1178,969,82.26
2016,G,BOULDER,2181007811,1358,182,1540,1241,80.58
2016,G,BOULDER,2181007812,1016,103,1119,908,81.14
2016,G,BOULDER,2181007813,916,192,1108,772,69.68
2016,G,BOULDER,2181007814,1117,193,1310,1026,78.32
2016,G,BOULDER,2181007815,811,353,1164,714,61.34
2016,G,BOULDER,2181007816,1124,322,1446,979,67.7
2016,G,BOULDER,2181007817,809,96,905,744,82.21
2016,G,BOULDER,2181007818,1069,162,1231,967,78.55
2016,G,BOULDER,2181007819,918,165,1083,825,76.18
2016,G,BOULDER,2181007820,709,110,819,654,79.85
2016,G,BOULDER,2181007821,1086,319,1405,974,69.32
2016,G,BOULDER,2181007822,1032,357,1389,891,64.15
2016,G,BOULDER,2181007823,1942,516,2458,1646,66.97
2016,G,BOULDER,2181007824,1087,255,1342,963,71.76
2016,G,BOULDER,2181007825,628,122,750,592,78.93
2016,G,BOULDER,2181007826,836,225,1061,775,73.04
2016,G,BOULDER,2181007827,912,369,1281,819,63.93
2016,G,BOULDER,2181007828,725,318,1043,634,60.79
2016,G,BOULDER,2181007829,752,439,1191,649,54.49
2016,G,BOULDER,2181007830,785,538,1323,645,48.75
2016,G,BOULDER,2181007831,888,637,1525,727,47.67
2016,G,BOULDER,2181007832,360,141,501,302,60.28
2016,G,BOULDER,2181007833,769,766,1535,632,41.17
2016,G,BOULDER,2181007834,1266,1343,2609,1058,40.55
2016,G,BOULDER,2181007835,665,469,1134,558,49.21
2016,G,BOULDER,2181007836,556,248,804,494,61.44
2016,G,BOULDER,2181007837,974,612,1586,825,52.02
2016,G,BOULDER,2181007838,511,321,832,431,51.8
2016,G,BOULDER,2181007839,631,88,719,579,80.53
2016,G,BOULDER,2181007840,606,165,771,532,69
2016,G,BOULDER,2181007841,733,132,865,674,77.92
2016,G,BOULDER,2181007842,1134,221,1355,1034,76.31
2016,G,BOULDER,2181007843,1262,162,1424,1166,81.88
2016,G,BOULDER,2181007844,754,186,940,665,70.74
2016,G,BOULDER,2181007845,881,331,1212,778,64.19
2016,G,BOULDER,2181007846,1334,537,1871,1105,59.06
2016,G,BOULDER,2181007847,782,501,1283,662,51.6
2016,G,BOULDER,2181007848,693,265,958,603,62.94
2016,G,BOULDER,2181007849,1010,1160,2170,826,38.06
2016,G,BOULDER,2181007850,668,74,742,622,83.83
2016,G,BOULDER,2181007851,1035,219,1254,955,76.16
2016,G,BOULDER,2181007852,1110,322,1432,1002,69.97
2016,G,BOULDER,2181007853,744,315,1059,633,59.77
2016,G,BOULDER,2181107505,847,135,982,771,78.51
2016,G,BOULDER,2181107506,597,64,661,549,83.06
2016,G,BOULDER,2181107507,1194,98,1292,1088,84.21
2016,G,BOULDER,2181107508,770,73,843,700,83.04
2016,G,BOULDER,2181107700,961,93,1054,870,82.54
2016,G,BOULDER,2181107701,553,48,601,511,85.02
2016,G,BOULDER,2181107702,331,25,356,301,84.55
2016,G,BOULDER,2181107703,467,38,505,434,85.94
2016,G,BOULDER,2181107704,349,46,395,311,78.73
2016,G,BOULDER,2181107705,670,55,725,611,84.28
2016,G,BOULDER,2181107912,1149,126,1275,1044,81.88
2016,G,BOULDER,2181107913,671,76,747,623,83.4
2016,G,BOULDER,2181107916,469,84,553,399,72.15
2016,G,BOULDER,2181107917,1290,198,1488,1161,78.02
2016,G,BOULDER,2181107918,1156,152,1308,1048,80.12
2016,G,BOULDER,2181207401,704,59,763,641,84.01
2016,G,BOULDER,2181207402,631,64,695,583,83.88
2016,G,BOULDER,2181207403,960,99,1059,866,81.78
2016,G,BOULDER,2181207404,985,84,1069,895,83.72
2016,G,BOULDER,2181207405,510,46,556,459,82.55
2016,G,BOULDER,2181207406,695,61,756,642,84.92
2016,G,BOULDER,2181307854,1007,331,1338,836,62.48
2016,G,BOULDER,2181307855,881,280,1161,790,68.04
2016,G,BOULDER,2181307856,604,118,722,555,76.87
2016,G,BOULDER,2181307857,891,127,1018,813,79.86
2016,G,BOULDER,2181307858,942,144,1086,893,82.23
2016,G,BOULDER,2181307859,855,93,948,801,84.49
2016,G,BOULDER,2181307860,662,78,740,611,82.57
2016,G,BOULDER,2181307861,632,82,714,583,81.65
2016,G,BOULDER,2181307862,658,92,750,616,82.13
2016,G,BOULDER,2181307863,800,114,914,744,81.4
2016,G,BOULDER,2181307864,678,109,787,632,80.3
2016,G,BOULDER,2181307865,672,240,912,580,63.6
2016,G,BOULDER,2181307866,872,231,1103,772,69.99
2016,G,BOULDER,2181307867,780,244,1024,699,68.26
2016,G,BOULDER,2181307868,881,105,986,814,82.56
2016,G,BOULDER,2181307869,613,148,761,552,72.54
2016,G,BOULDER,2181307870,769,232,1001,657,65.63
2016,G,BOULDER,2181307871,788,366,1154,697,60.4
2016,G,BOULDER,2181307872,977,688,1665,790,47.45
2016,G,BOULDER,2181307873,482,69,551,436,79.13
2016,G,BOULDER,2181307874,1095,278,1373,962,70.07
2016,G,BOULDER,2181307875,688,610,1298,538,41.45
2016,G,BOULDER,2181307876,811,932,1743,626,35.92
2016,G,BOULDER,2181307877,745,307,1052,653,62.07
2016,G,BOULDER,2181307878,738,456,1194,635,53.18
2016,G,BOULDER,2181307879,750,480,1230,654,53.17
2016,G,BOULDER,2181307880,1054,1139,2193,848,38.67
2016,G,BOULDER,2181307881,708,276,984,623,63.31
2016,G,BOULDER,2181307882,665,156,821,597,72.72
2016,G,BOULDER,2181307883,798,209,1007,730,72.49
2016,G,BOULDER,2181307884,965,496,1461,825,56.47
2016,G,BOULDER,2181307885,604,130,734,560,76.29
2016,G,BOULDER,2181307886,830,115,945,756,80
2016,G,BOULDER,2181307887,1021,122,1143,936,81.89
2016,G,BOULDER,2181307888,856,82,938,798,85.07
2016,G,BOULDER,2181307903,1853,447,2300,1636,71.13
2016,G,BOULDER,2181307904,506,88,594,448,75.42
2016,G,BOULDER,2181307905,278,29,307,248,80.78
2016,G,BOULDER,2181307906,560,58,618,518,83.82
2016,G,BOULDER,2181307908,970,123,1093,859,78.59
2016,G,BOULDER,2181307909,568,101,669,510,76.23
2016,G,BOULDER,2181307910,785,109,894,715,79.98
2016,G,BOULDER,2181307911,932,123,1055,855,81.04
2016,G,BOULDER,2181307914,571,99,670,523,78.06
2016,G,BOULDER,2181307915,403,66,469,338,72.07
2016,G,BOULDER,4171107616,1100,98,1198,990,82.64
2016,G,BOULDER,4171107617,1739,287,2026,1575,77.74
2016,G,BOULDER,4171107618,1541,132,1673,1400,83.68
2016,G,BOULDER,4171107619,1560,365,1925,1265,65.71
2016,G,BOULDER,4171107620,1427,309,1736,1265,72.87
2016,G,BOULDER,4171107621,1072,170,1242,962,77.46
2016,G,BOULDER,4171107622,736,134,870,615,70.69
2016,G,BOULDER,4171107623,1217,323,1540,1021,66.3
2016,G,BOULDER,4171107624,881,173,1054,792,75.14
2016,G,BOULDER,4171107625,846,115,961,766,79.71
2016,G,BOULDER,4171107626,1115,166,1281,986,76.97
2016,G,BOULDER,4171107627,787,218,1005,637,63.38
2016,G,BOULDER,4171107628,900,95,995,805,80.9
2016,G,BOULDER,4171107629,617,100,717,541,75.45
2016,G,BOULDER,4171107630,913,198,1111,752,67.69
2016,G,BOULDER,4171107631,643,125,768,534,69.53
2016,G,BOULDER,4171107632,1244,164,1408,1085,77.06
2016,G,BOULDER,4171107633,916,225,1141,704,61.7
2016,G,BOULDER,4171107634,808,204,1012,665,65.71
2016,G,BOULDER,4171107635,819,109,928,728,78.45
2016,G,BOULDER,4171107636,1135,140,1275,1006,78.9
2016,G,BOULDER,4171107637,1294,259,1553,1111,71.54
2016,G,BOULDER,4171107638,970,78,1048,907,86.55
2016,G,BOULDER,4171107639,909,99,1008,833,82.64
2016,G,BOULDER,4171107640,869,130,999,767,76.78
2016,G,BOULDER,4171107641,832,134,966,730,75.57
2016,G,BOULDER,4171107642,1227,179,1406,1056,75.11
2016,G,BOULDER,4171107643,775,157,932,642,68.88
2016,G,BOULDER,4171107644,852,235,1087,666,61.27
2016,G,BOULDER,4171107645,850,118,968,734,75.83
2016,G,BOULDER,4171107646,911,132,1043,825,79.1
2016,G,BOULDER,4171107647,1311,122,1433,1198,83.6
2016,G,BOULDER,4171107648,994,203,1197,819,68.42
2016,G,BOULDER,4171107649,765,162,927,607,65.48
2016,G,BOULDER,4171107650,828,134,962,711,73.91
2016,G,BOULDER,4171107651,995,134,1129,846,74.93
2016,G,BOULDER,4171107652,1023,272,1295,851,65.71
2016,G,BOULDER,4171107653,731,59,790,670,84.81
2016,G,BOULDER,4171107654,1333,342,1675,1157,69.07
2016,G,BOULDER,4171207600,1565,231,1796,1399,77.9
2016,G,BOULDER,4171207601,1477,165,1642,1322,80.51
2016,G,BOULDER,4171207602,805,129,934,727,77.84
2016,G,BOULDER,4171207603,1272,138,1410,1141,80.92
2016,G,BOULDER,4171207604,997,102,1099,888,80.8
2016,G,BOULDER,4171207605,1077,175,1252,919,73.4
2016,G,BOULDER,4171207606,783,142,925,683,73.84
2016,G,BOULDER,4171207607,992,158,1150,875,76.09
2016,G,BOULDER,4171207608,942,249,1191,740,62.13
2016,G,BOULDER,4171207609,512,150,662,392,59.21
2016,G,BOULDER,4171207610,1597,344,1941,1316,67.8
2016,G,BOULDER,4171207611,1087,184,1271,930,73.17
2016,G,BOULDER,4171207612,920,105,1025,847,82.63
2016,G,BOULDER,4171207613,885,120,1005,786,78.21
2016,G,BOULDER,4171207614,1337,192,1529,1230,80.44
2016,G,BOULDER,4171207615,804,103,907,728,80.26
2016,G,BOULDER,4181107706,190,13,203,168,82.76
2016,G,BOULDER,4181107707,634,54,688,582,84.59
2016,G,BOULDER,4181107708,710,77,787,637,80.94
2016,G,BROOMFIELD,2233364001,594,163,757,517,68.3
2016,G,BROOMFIELD,2233364002,1930,511,2441,1619,66.33
2016,G,BROOMFIELD,2233364003,1408,309,1717,1219,71
2016,G,BROOMFIELD,2233364004,1675,311,1986,1475,74.27
2016,G,BROOMFIELD,2233364005,94,52,146,67,45.89
2016,G,BROOMFIELD,2233364006,1602,238,1840,1350,73.37
2016,G,BROOMFIELD,2233364007,812,206,1018,684,67.19
2016,G,BROOMFIELD,2233364008,662,133,795,554,69.69
2016,G,BROOMFIELD,2233364009,789,131,920,708,76.96
2016,G,BROOMFIELD,2233364010,1117,98,1215,1021,84.03
2016,G,BROOMFIELD,2233364011,1117,105,1222,984,80.52
2016,G,BROOMFIELD,2233364012,1187,60,1247,1096,87.89
2016,G,BROOMFIELD,2233364013,932,161,1093,829,75.85
2016,G,BROOMFIELD,2233364014,992,145,1137,868,76.34
2016,G,BROOMFIELD,2233364015,1116,116,1232,990,80.36
2016,G,BROOMFIELD,2233364016,1106,87,1193,1021,85.58
2016,G,BROOMFIELD,2233364017,1524,123,1647,1394,84.64
2016,G,BROOMFIELD,2233364018,868,172,1040,758,72.88
2016,G,BROOMFIELD,2233364019,1279,249,1528,1049,68.65
2016,G,BROOMFIELD,2233364020,934,122,1056,817,77.37
2016,G,BROOMFIELD,2233364021,1803,254,2057,1599,77.73
2016,G,BROOMFIELD,2233364022,1190,139,1329,1089,81.94
2016,G,BROOMFIELD,2233364023,1040,74,1114,941,84.47
2016,G,BROOMFIELD,2233364024,1917,163,2080,1739,83.61
2016,G,BROOMFIELD,2233364025,1884,220,2104,1700,80.8
2016,G,BROOMFIELD,2233364026,1131,106,1237,1044,84.4
2016,G,BROOMFIELD,2233364027,1446,252,1698,1263,74.38
2016,G,BROOMFIELD,2233364028,554,134,688,436,63.37
2016,G,BROOMFIELD,2233364029,1128,128,1256,991,78.9
2016,G,BROOMFIELD,2233364030,1108,138,1246,945,75.84
2016,G,BROOMFIELD,2233364031,976,118,1094,830,75.87
2016,G,BROOMFIELD,2233364032,1772,201,1973,1637,82.97
2016,G,BROOMFIELD,2233364033,1533,173,1706,1426,83.59
2016,G,BROOMFIELD,2233364034,557,38,595,513,86.22
2016,G,BROOMFIELD,2233364035,1803,61,1864,1735,93.08
2016,G,BROOMFIELD,2233364036,1793,165,1958,1667,85.14
2016,G,BROOMFIELD,2233364037,184,9,193,162,83.94
2016,G,CHAFFEE,5056008001,596,79,675,528,78.22
2016,G,CHAFFEE,5056008002,646,124,770,577,74.94
2016,G,CHAFFEE,5056008003,1059,170,1229,907,73.8
2016,G,CHAFFEE,5056008004,1062,135,1197,941,78.61
2016,G,CHAFFEE,5056008005,1046,104,1150,956,83.13
2016,G,CHAFFEE,5056008006,1019,98,1117,911,81.56
2016,G,CHAFFEE,5056008007,1400,187,1587,1262,79.52
2016,G,CHAFFEE,5056008008,780,75,855,694,81.17
2016,G,CHAFFEE,5056008009,918,88,1006,826,82.11
2016,G,CHAFFEE,5056008010,941,113,1054,827,78.46
2016,G,CHAFFEE,5056008011,792,109,901,704,78.14
2016,G,CHAFFEE,5056008012,648,114,762,565,74.15
2016,G,CHAFFEE,5056008013,960,111,1071,875,81.7
2016,G,CHAFFEE,5056008014,648,97,745,566,75.97
2016,G,CHAFFEE,5056008015,518,77,595,464,77.98
2016,G,CHEYENNE,4016509001,151,15,166,129,77.71
2016,G,CHEYENNE,4016509002,342,62,404,299,74.01
2016,G,CHEYENNE,4016509003,424,33,457,375,82.06
2016,G,CHEYENNE,4016509004,290,30,320,253,79.06
2016,G,CHEYENNE,4016509005,68,2,70,65,92.86
2016,G,CLEAR CREEK,2021310001,995,126,1121,843,75.2
2016,G,CLEAR CREEK,2021310002,376,74,450,299,66.44
2016,G,CLEAR CREEK,2021310003,447,54,501,369,73.65
2016,G,CLEAR CREEK,2021310004,914,145,1059,746,70.44
2016,G,CLEAR CREEK,2021310005,817,106,923,676,73.24
2016,G,CLEAR CREEK,2021310006,535,77,612,433,70.75
2016,G,CLEAR CREEK,2021310007,1197,138,1335,1048,78.5
2016,G,CLEAR CREEK,2021310008,725,89,814,658,80.84
2016,G,CLEAR CREEK,2021310009,1055,117,1172,961,82
2016,G,CONEJOS,3356211001,451,75,526,370,70.34
2016,G,CONEJOS,3356211002,506,97,603,432,71.64
2016,G,CONEJOS,3356211003,377,93,470,343,72.98
2016,G,CONEJOS,3356211004,491,74,565,403,71.33
2016,G,CONEJOS,3356211005,517,113,630,422,66.98
2016,G,CONEJOS,3356211006,644,94,738,559,75.75
2016,G,CONEJOS,3356211007,352,58,410,302,73.66
2016,G,CONEJOS,3356211008,731,103,834,632,75.78
2016,G,CONEJOS,3356211009,446,63,509,391,76.82
2016,G,CONEJOS,3356211010,411,67,478,314,65.69
2016,G,COSTILLA,3356212001,201,35,236,172,72.88
2016,G,COSTILLA,3356212002,247,33,280,205,73.21
2016,G,COSTILLA,3356212003,169,14,183,140,76.5
2016,G,COSTILLA,3356212004,324,47,371,256,69
2016,G,COSTILLA,3356212005,182,59,241,143,59.34
2016,G,COSTILLA,3356212006,98,31,129,77,59.69
2016,G,COSTILLA,3356212007,732,155,887,595,67.08
2016,G,COSTILLA,3356212008,467,129,596,366,61.41
2016,G,CROWLEY,4356413001,382,54,436,321,73.62
2016,G,CROWLEY,4356413002,318,42,360,267,74.17
2016,G,CROWLEY,4356413003,260,37,297,222,74.75
2016,G,CROWLEY,4356413004,295,34,329,244,74.16
2016,G,CROWLEY,4356413005,305,34,339,248,73.16
2016,G,CROWLEY,4356413006,297,38,335,260,77.61
2016,G,CUSTER,3356014001,1781,217,1998,1612,80.68
2016,G,CUSTER,3356014002,379,55,434,338,77.88
2016,G,CUSTER,3356014003,1288,146,1434,1197,83.47
2016,G,DELTA,3055415001,1118,93,1211,1040,85.88
2016,G,DELTA,3055415002,721,117,838,622,74.22
2016,G,DELTA,3055415003,661,161,822,529,64.36
2016,G,DELTA,3055415004,1037,231,1268,864,68.14
2016,G,DELTA,3055415005,752,103,855,640,74.85
2016,G,DELTA,3055415006,973,158,1131,842,74.45
2016,G,DELTA,3055415007,983,130,1113,874,78.53
2016,G,DELTA,3056115008,1091,147,1238,960,77.54
2016,G,DELTA,3056115009,1168,157,1325,1039,78.42
2016,G,DELTA,3056115010,1043,149,1192,935,78.44
2016,G,DELTA,3056115011,944,156,1100,843,76.64
2016,G,DELTA,3056115012,758,142,900,687,76.33
2016,G,DELTA,3056115013,909,96,1005,829,82.49
2016,G,DELTA,3056115014,1091,114,1205,1018,84.48
2016,G,DELTA,3056115015,1272,140,1412,1136,80.45
2016,G,DELTA,3056115016,1006,161,1167,918,78.66
2016,G,DELTA,3056115017,968,151,1119,867,77.48
2016,G,DELTA,3056115018,1113,130,1243,1004,80.77
2016,G,DELTA,3056115019,821,137,958,720,75.16
2016,G,DELTA,3056115020,968,124,1092,849,77.75
2016,G,DENVER,1160116112,1082,133,1215,937,77.12
2016,G,DENVER,1160116113,1021,67,1088,880,80.88
2016,G,DENVER,1160116114,1205,149,1354,997,73.63
2016,G,DENVER,1160116120,1472,373,1845,1150,62.33
2016,G,DENVER,1160116122,1223,102,1325,1055,79.62
2016,G,DENVER,1160116123,1232,124,1356,1104,81.42
2016,G,DENVER,1160116124,1154,100,1254,1004,80.06
2016,G,DENVER,1160116125,1237,158,1395,1052,75.41
2016,G,DENVER,1160116126,1404,285,1689,1168,69.15
2016,G,DENVER,1160116127,1503,213,1716,1303,75.93
2016,G,DENVER,1160116128,952,66,1018,858,84.28
2016,G,DENVER,1160116129,838,59,897,747,83.28
2016,G,DENVER,1160116130,1181,118,1299,964,74.21
2016,G,DENVER,1160116131,1198,91,1289,1015,78.74
2016,G,DENVER,1160116132,1261,191,1452,1133,78.03
2016,G,DENVER,1310216204,1541,500,2041,1297,63.55
2016,G,DENVER,1310216205,1362,381,1743,1115,63.97
2016,G,DENVER,1310216206,1744,532,2276,1470,64.59
2016,G,DENVER,1310216207,1366,306,1672,1175,70.28
2016,G,DENVER,1310216208,1432,340,1772,1196,67.49
2016,G,DENVER,1310216209,1112,244,1356,1006,74.19
2016,G,DENVER,1310216210,1309,235,1544,1151,74.55
2016,G,DENVER,1310216211,1126,257,1383,991,71.66
2016,G,DENVER,1310516530,126,36,162,95,58.64
2016,G,DENVER,1310616605,825,69,894,762,85.23
2016,G,DENVER,1310616606,936,118,1054,871,82.64
2016,G,DENVER,1310616607,747,64,811,677,83.48
2016,G,DENVER,1310616609,311,20,331,285,86.1
2016,G,DENVER,1310616610,390,38,428,366,85.51
2016,G,DENVER,1310616611,791,115,906,715,78.92
2016,G,DENVER,1310616612,1102,162,1264,974,77.06
2016,G,DENVER,1310616613,1137,142,1279,1041,81.39
2016,G,DENVER,1310616614,736,65,801,664,82.9
2016,G,DENVER,1310616615,948,86,1034,882,85.3
2016,G,DENVER,1310616617,982,135,1117,888,79.5
2016,G,DENVER,1310616618,907,108,1015,844,83.15
2016,G,DENVER,1310616619,902,103,1005,831,82.69
2016,G,DENVER,1310616622,1143,65,1208,1033,85.51
2016,G,DENVER,1310616623,1267,77,1344,1170,87.05
2016,G,DENVER,1310616624,1293,104,1397,1201,85.97
2016,G,DENVER,1310616625,851,85,936,763,81.52
2016,G,DENVER,1310616626,796,163,959,731,76.23
2016,G,DENVER,1310616627,1134,84,1218,1042,85.55
2016,G,DENVER,1310616628,1403,208,1611,1195,74.18
2016,G,DENVER,1310616629,837,53,890,776,87.19
2016,G,DENVER,1310616630,824,39,863,765,88.64
2016,G,DENVER,1310616631,1864,505,2369,1549,65.39
2016,G,DENVER,1310616641,1379,174,1553,1189,76.56
2016,G,DENVER,1310616642,1084,93,1177,960,81.56
2016,G,DENVER,1310616643,887,131,1018,736,72.3
2016,G,DENVER,1310616644,1054,89,1143,973,85.13
2016,G,DENVER,1310616645,978,73,1051,893,84.97
2016,G,DENVER,1310616646,1506,447,1953,1154,59.09
2016,G,DENVER,1310616647,1221,149,1370,988,72.12
2016,G,DENVER,1310616648,1235,146,1381,1059,76.68
2016,G,DENVER,1310616649,1772,550,2322,1336,57.54
2016,G,DENVER,1310616650,1066,212,1278,916,71.67
2016,G,DENVER,1310616651,1227,495,1722,980,56.91
2016,G,DENVER,1310616652,1034,88,1122,954,85.03
2016,G,DENVER,1310816841,1263,318,1581,1100,69.58
2016,G,DENVER,1310816842,979,191,1170,861,73.59
2016,G,DENVER,1310816843,1099,243,1342,957,71.31
2016,G,DENVER,1310816844,1361,297,1658,1153,69.54
2016,G,DENVER,1310816845,1171,218,1389,1014,73
2016,G,DENVER,1310816846,1152,217,1369,1027,75.02
2016,G,DENVER,1310816848,1279,233,1512,1136,75.13
2016,G,DENVER,1310816849,1248,275,1523,1149,75.44
2016,G,DENVER,1310816850,1074,126,1200,1000,83.33
2016,G,DENVER,1310816851,1282,209,1491,1142,76.59
2016,G,DENVER,1310816852,936,107,1043,862,82.65
2016,G,DENVER,1310816853,956,56,1012,892,88.14
2016,G,DENVER,1310816854,1098,165,1263,1011,80.05
2016,G,DENVER,1310816855,2020,379,2399,1667,69.49
2016,G,DENVER,1310916901,1457,426,1883,1181,62.72
2016,G,DENVER,1310916903,1282,115,1397,1139,81.53
2016,G,DENVER,1310916904,1207,105,1312,1089,83
2016,G,DENVER,1310916905,305,21,326,271,83.13
2016,G,DENVER,1310916906,1083,91,1174,1011,86.12
2016,G,DENVER,1310916908,1287,164,1451,1107,76.29
2016,G,DENVER,1310916909,1270,103,1373,1137,82.81
2016,G,DENVER,1310916910,1525,238,1763,1340,76.01
2016,G,DENVER,1310916911,1835,469,2304,1465,63.59
2016,G,DENVER,1310916912,1364,234,1598,1142,71.46
2016,G,DENVER,1310916916,1779,171,1950,1538,78.87
2016,G,DENVER,1310916917,1443,132,1575,1286,81.65
2016,G,DENVER,1310916918,1327,69,1396,1230,88.11
2016,G,DENVER,1310916919,1323,84,1407,1234,87.7
2016,G,DENVER,1310916920,1257,118,1375,1118,81.31
2016,G,DENVER,1310916921,1791,526,2317,1357,58.57
2016,G,DENVER,1310916922,1770,437,2207,1498,67.87
2016,G,DENVER,1310916923,1523,373,1896,1217,64.19
2016,G,DENVER,1310916924,1393,614,2007,925,46.09
2016,G,DENVER,1310916927,991,116,1107,892,80.58
2016,G,DENVER,1310916928,859,39,898,797,88.75
2016,G,DENVER,1310916929,991,148,1139,871,76.47
2016,G,DENVER,1310916930,1000,126,1126,835,74.16
2016,G,DENVER,1310916931,772,54,826,726,87.89
2016,G,DENVER,1310916932,1117,173,1290,942,73.02
2016,G,DENVER,1310916933,768,39,807,684,84.76
2016,G,DENVER,1310916934,899,141,1040,743,71.44
2016,G,DENVER,1310916935,2077,515,2592,1761,67.94
2016,G,DENVER,1310916936,1136,276,1412,922,65.3
2016,G,DENVER,1310916937,1080,73,1153,983,85.26
2016,G,DENVER,1310916938,1119,190,1309,964,73.64
2016,G,DENVER,1320116103,1355,140,1495,1051,70.3
2016,G,DENVER,1320116104,1176,187,1363,806,59.13
2016,G,DENVER,1320116105,1443,125,1568,1162,74.11
2016,G,DENVER,1320116106,1524,164,1688,1187,70.32
2016,G,DENVER,1320116107,1604,187,1791,1277,71.3
2016,G,DENVER,1320116108,1631,179,1810,1305,72.1
2016,G,DENVER,1320116109,1050,123,1173,701,59.76
2016,G,DENVER,1320116110,1366,98,1464,1166,79.64
2016,G,DENVER,1320116111,1521,134,1655,1230,74.32
2016,G,DENVER,1320116115,456,21,477,400,83.86
2016,G,DENVER,1320116116,1217,78,1295,1054,81.39
2016,G,DENVER,1320116117,1097,74,1171,922,78.74
2016,G,DENVER,1320116118,1264,327,1591,931,58.52
2016,G,DENVER,1320116119,1362,237,1599,937,58.6
2016,G,DENVER,1320116121,1208,90,1298,1018,78.43
2016,G,DENVER,1320216212,1270,237,1507,1122,74.45
2016,G,DENVER,1320216213,1034,121,1155,854,73.94
2016,G,DENVER,1320216214,1029,213,1242,898,72.3
2016,G,DENVER,1320216215,1616,276,1892,1398,73.89
2016,G,DENVER,1320216216,1169,201,1370,1035,75.55
2016,G,DENVER,1320216217,1231,178,1409,1110,78.78
2016,G,DENVER,1320216218,1959,381,2340,1700,72.65
2016,G,DENVER,1320216219,1826,388,2214,1621,73.22
2016,G,DENVER,1320216220,1701,210,1911,1479,77.39
2016,G,DENVER,1320216221,1731,246,1977,1541,77.95
2016,G,DENVER,1320216222,1025,156,1181,902,76.38
2016,G,DENVER,1320216223,837,118,955,772,80.84
2016,G,DENVER,1320216224,1295,153,1448,1131,78.11
2016,G,DENVER,1320216225,848,111,959,779,81.23
2016,G,DENVER,1320216226,884,117,1001,806,80.52
2016,G,DENVER,1320216227,927,152,1079,855,79.24
2016,G,DENVER,1320216228,618,49,667,572,85.76
2016,G,DENVER,1320216229,760,78,838,695,82.94
2016,G,DENVER,1320216230,844,85,929,782,84.18
2016,G,DENVER,1320216231,930,113,1043,850,81.5
2016,G,DENVER,1320216232,905,251,1156,724,62.63
2016,G,DENVER,1320216233,1781,218,1999,1617,80.89
2016,G,DENVER,1320216234,1606,178,1784,1458,81.73
2016,G,DENVER,1320216235,1425,146,1571,1307,83.2
2016,G,DENVER,1320216236,1057,142,1199,947,78.98
2016,G,DENVER,1320216237,2095,1015,3110,1699,54.63
2016,G,DENVER,1320216238,1769,362,2131,1553,72.88
2016,G,DENVER,1320216239,1272,161,1433,1100,76.76
2016,G,DENVER,1320216240,1011,130,1141,806,70.64
2016,G,DENVER,1320216241,1034,138,1172,912,77.82
2016,G,DENVER,1320216242,990,135,1125,871,77.42
2016,G,DENVER,1320216243,1154,194,1348,1018,75.52
2016,G,DENVER,1320216244,1161,256,1417,998,70.43
2016,G,DENVER,1320216245,1171,119,1290,1068,82.79
2016,G,DENVER,1320216246,1142,126,1268,1051,82.89
2016,G,DENVER,1320216247,793,87,880,687,78.07
2016,G,DENVER,1320216248,983,71,1054,890,84.44
2016,G,DENVER,1320216249,1308,43,1351,1232,91.19
2016,G,DENVER,1320216250,1239,88,1327,1136,85.61
2016,G,DENVER,1320516532,674,127,801,558,69.66
2016,G,DENVER,1320516533,1394,154,1548,1065,68.8
2016,G,DENVER,1320516534,1309,140,1449,1003,69.22
2016,G,DENVER,1320516535,1489,151,1640,1161,70.79
2016,G,DENVER,1320516536,1161,106,1267,865,68.27
2016,G,DENVER,1320516537,1351,179,1530,976,63.79
2016,G,DENVER,1320516538,1090,131,1221,806,66.01
2016,G,DENVER,1320516539,1022,125,1147,746,65.04
2016,G,DENVER,1320616608,1296,94,1390,1203,86.55
2016,G,DENVER,1320616616,1226,69,1295,1136,87.72
2016,G,DENVER,1320616620,1203,237,1440,1032,71.67
2016,G,DENVER,1320616621,1131,147,1278,1012,79.19
2016,G,DENVER,1320616632,1102,137,1239,1008,81.36
2016,G,DENVER,1320616633,1064,98,1162,990,85.2
2016,G,DENVER,1320616634,826,64,890,766,86.07
2016,G,DENVER,1320616635,1268,107,1375,1144,83.2
2016,G,DENVER,1320616636,1171,104,1275,1086,85.18
2016,G,DENVER,1320616637,1134,84,1218,1061,87.11
2016,G,DENVER,1320616638,634,51,685,596,87.01
2016,G,DENVER,1320616639,1073,74,1147,981,85.53
2016,G,DENVER,1320616640,1381,141,1522,1277,83.9
2016,G,DENVER,1320916902,1986,554,2540,1550,61.02
2016,G,DENVER,1320916907,1491,269,1760,1210,68.75
2016,G,DENVER,1320916913,1336,124,1460,1201,82.26
2016,G,DENVER,1320916914,1069,103,1172,963,82.17
2016,G,DENVER,1320916915,1093,121,1214,962,79.24
2016,G,DENVER,1320916925,732,29,761,662,86.99
2016,G,DENVER,1320916926,765,57,822,669,81.39
2016,G,DENVER,1330516516,715,119,834,539,64.63
2016,G,DENVER,1330516520,2652,2531,5183,877,16.92
2016,G,DENVER,1330516521,1115,197,1312,875,66.69
2016,G,DENVER,1330616601,618,73,691,559,80.9
2016,G,DENVER,1330616602,895,167,1062,740,69.68
2016,G,DENVER,1330616603,980,186,1166,820,70.33
2016,G,DENVER,1330616604,1573,495,2068,1130,54.64
2016,G,DENVER,1330716701,1182,236,1418,936,66.01
2016,G,DENVER,1330716702,1307,95,1402,1209,86.23
2016,G,DENVER,1330716703,667,89,756,605,80.03
2016,G,DENVER,1330716704,837,109,946,670,70.82
2016,G,DENVER,1330716705,1147,173,1320,1054,79.85
2016,G,DENVER,1330716706,1031,90,1121,973,86.8
2016,G,DENVER,1330716707,844,82,926,796,85.96
2016,G,DENVER,1330716708,1378,142,1520,1290,84.87
2016,G,DENVER,1330716709,804,115,919,672,73.12
2016,G,DENVER,1330716710,886,119,1005,811,80.7
2016,G,DENVER,1330716711,440,63,503,387,76.94
2016,G,DENVER,1330716712,269,32,301,213,70.76
2016,G,DENVER,1330716713,980,129,1109,892,80.43
2016,G,DENVER,1330716714,1126,257,1383,778,56.25
2016,G,DENVER,1330716715,1085,122,1207,752,62.3
2016,G,DENVER,1330716716,958,157,1115,656,58.83
2016,G,DENVER,1330716717,1069,173,1242,740,59.58
2016,G,DENVER,1330716718,1113,146,1259,760,60.37
2016,G,DENVER,1330716719,975,108,1083,704,65
2016,G,DENVER,1330716720,1072,231,1303,719,55.18
2016,G,DENVER,1330716721,923,83,1006,698,69.38
2016,G,DENVER,1330716722,1082,110,1192,805,67.53
2016,G,DENVER,1330716723,1054,98,1152,803,69.7
2016,G,DENVER,1330716724,1005,114,1119,747,66.76
2016,G,DENVER,1330716725,1040,177,1217,739,60.72
2016,G,DENVER,1330716726,1031,142,1173,763,65.05
2016,G,DENVER,1330716727,1104,162,1266,856,67.61
2016,G,DENVER,1330716728,1090,292,1382,835,60.42
2016,G,DENVER,1330716729,1466,142,1608,1221,75.93
2016,G,DENVER,1330716730,1465,145,1610,1239,76.96
2016,G,DENVER,1330716731,1424,179,1603,1186,73.99
2016,G,DENVER,1330716732,919,123,1042,729,69.96
2016,G,DENVER,1330716733,1311,400,1711,1011,59.09
2016,G,DENVER,1330716734,1274,276,1550,965,62.26
2016,G,DENVER,1330716735,1011,148,1159,782,67.47
2016,G,DENVER,1330716736,883,122,1005,660,65.67
2016,G,DENVER,1330716737,1025,134,1159,778,67.13
2016,G,DENVER,1330716738,1045,100,1145,813,71
2016,G,DENVER,1330716739,991,116,1107,761,68.74
2016,G,DENVER,1330716740,987,120,1107,783,70.73
2016,G,DENVER,1330716741,1070,150,1220,817,66.97
2016,G,DENVER,1330716742,729,171,900,587,65.22
2016,G,DENVER,1330716743,911,48,959,870,90.72
2016,G,DENVER,1330716744,2662,101,2763,2495,90.3
2016,G,DENVER,1330816801,951,202,1153,720,62.45
2016,G,DENVER,1330816802,982,150,1132,785,69.35
2016,G,DENVER,1330816803,929,147,1076,658,61.15
2016,G,DENVER,1330816804,906,123,1029,700,68.03
2016,G,DENVER,1330816805,914,179,1093,683,62.49
2016,G,DENVER,1330816806,1869,269,2138,1433,67.03
2016,G,DENVER,1330816807,1332,185,1517,989,65.19
2016,G,DENVER,1330816808,1328,254,1582,953,60.24
2016,G,DENVER,1330816810,1261,242,1503,990,65.87
2016,G,DENVER,1330816811,1152,198,1350,905,67.04
2016,G,DENVER,1330816812,1126,156,1282,911,71.06
2016,G,DENVER,1330816813,1138,198,1336,853,63.85
2016,G,DENVER,1330816814,929,149,1078,747,69.29
2016,G,DENVER,1330816815,880,128,1008,742,73.61
2016,G,DENVER,1330816816,848,110,958,713,74.43
2016,G,DENVER,1330816817,956,113,1069,788,73.71
2016,G,DENVER,1330816818,798,119,917,635,69.25
2016,G,DENVER,1330816819,835,106,941,677,71.94
2016,G,DENVER,1330816820,1036,124,1160,884,76.21
2016,G,DENVER,1330816821,958,115,1073,824,76.79
2016,G,DENVER,1330816822,1091,122,1213,915,75.43
2016,G,DENVER,1330816823,1047,73,1120,978,87.32
2016,G,DENVER,1330816824,995,103,1098,905,82.42
2016,G,DENVER,1330816825,992,88,1080,883,81.76
2016,G,DENVER,1330816826,1148,268,1416,910,64.27
2016,G,DENVER,1330816827,1237,188,1425,1071,75.16
2016,G,DENVER,1330816828,1556,547,2103,1183,56.25
2016,G,DENVER,1330816829,1344,253,1597,1205,75.45
2016,G,DENVER,1330816830,1127,184,1311,1003,76.51
2016,G,DENVER,1330816831,958,45,1003,900,89.73
2016,G,DENVER,1330816832,976,63,1039,912,87.78
2016,G,DENVER,1330816833,1101,90,1191,1015,85.22
2016,G,DENVER,1330816834,1027,112,1139,950,83.41
2016,G,DENVER,1330816835,1080,70,1150,991,86.17
2016,G,DENVER,1330816836,1414,423,1837,1138,61.95
2016,G,DENVER,1330816837,1218,276,1494,1000,66.93
2016,G,DENVER,1330816838,1252,248,1500,908,60.53
2016,G,DENVER,1330816839,542,42,584,499,85.45
2016,G,DENVER,1330816840,541,44,585,514,87.86
2016,G,DENVER,1330816847,601,80,681,529,77.68
2016,G,DENVER,1340116101,1479,216,1695,996,58.76
2016,G,DENVER,1340116102,1523,198,1721,1044,60.66
2016,G,DENVER,1340216201,1531,394,1925,1307,67.9
2016,G,DENVER,1340216202,1439,479,1918,1130,58.92
2016,G,DENVER,1340216203,1080,300,1380,870,63.04
2016,G,DENVER,1340416401,1248,134,1382,1066,77.13
2016,G,DENVER,1340416402,1618,357,1975,1331,67.39
2016,G,DENVER,1340416403,1209,125,1334,971,72.79
2016,G,DENVER,1340416404,1306,176,1482,1160,78.27
2016,G,DENVER,1340416405,1264,104,1368,1139,83.26
2016,G,DENVER,1340416406,1052,117,1169,907,77.59
2016,G,DENVER,1340416407,1402,153,1555,1260,81.03
2016,G,DENVER,1340416408,1425,151,1576,1230,78.05
2016,G,DENVER,1340416409,1183,112,1295,1056,81.54
2016,G,DENVER,1340416410,1008,110,1118,890,79.61
2016,G,DENVER,1340416411,1094,138,1232,921,74.76
2016,G,DENVER,1340416412,1411,166,1577,1278,81.04
2016,G,DENVER,1340416413,1399,109,1508,1298,86.07
2016,G,DENVER,1340416414,1340,139,1479,1220,82.49
2016,G,DENVER,1340416415,1469,188,1657,1316,79.42
2016,G,DENVER,1340416416,1312,178,1490,1147,76.98
2016,G,DENVER,1340416417,1058,103,1161,936,80.62
2016,G,DENVER,1340416418,1550,266,1816,1329,73.18
2016,G,DENVER,1340416419,1338,128,1466,1216,82.95
2016,G,DENVER,1340416420,1421,163,1584,1166,73.61
2016,G,DENVER,1340416421,1482,207,1689,1300,76.97
2016,G,DENVER,1340416422,1375,154,1529,1213,79.33
2016,G,DENVER,1340416423,1233,231,1464,863,58.95
2016,G,DENVER,1340416424,1344,175,1519,1080,71.1
2016,G,DENVER,1340416425,1135,237,1372,799,58.24
2016,G,DENVER,1340416426,1640,428,2068,1174,56.77
2016,G,DENVER,1340416427,459,186,645,267,41.4
2016,G,DENVER,1340416428,1422,232,1654,990,59.85
2016,G,DENVER,1340416429,1358,173,1531,977,63.81
2016,G,DENVER,1340416430,1135,170,1305,873,66.9
2016,G,DENVER,1340416431,1470,133,1603,1121,69.93
2016,G,DENVER,1340416432,1264,180,1444,953,66
2016,G,DENVER,1340416433,1375,131,1506,1016,67.46
2016,G,DENVER,1340416434,1319,161,1480,959,64.8
2016,G,DENVER,1340416435,1234,132,1366,842,61.64
2016,G,DENVER,1340416436,1220,216,1436,794,55.29
2016,G,DENVER,1340516501,1238,129,1367,973,71.18
2016,G,DENVER,1340516502,966,128,1094,688,62.89
2016,G,DENVER,1340516503,1261,196,1457,870,59.71
2016,G,DENVER,1340516504,1085,142,1227,764,62.27
2016,G,DENVER,1340516505,1131,135,1266,861,68.01
2016,G,DENVER,1340516506,1084,127,1211,931,76.88
2016,G,DENVER,1340516507,1193,154,1347,918,68.15
2016,G,DENVER,1340516508,942,99,1041,843,80.98
2016,G,DENVER,1340516509,1286,159,1445,1091,75.5
2016,G,DENVER,1340516510,867,231,1098,631,57.47
2016,G,DENVER,1340516511,1035,161,1196,888,74.25
2016,G,DENVER,1340516512,1300,266,1566,1112,71.01
2016,G,DENVER,1340516513,2154,262,2416,1934,80.05
2016,G,DENVER,1340516514,1401,368,1769,1214,68.63
2016,G,DENVER,1340516515,2532,510,3042,2136,70.22
2016,G,DENVER,1340516517,841,165,1006,732,72.76
2016,G,DENVER,1340516518,847,147,994,717,72.13
2016,G,DENVER,1340516519,1327,457,1784,1008,56.5
2016,G,DENVER,1340516522,2379,374,2753,1949,70.8
2016,G,DENVER,1340516523,1507,385,1892,1330,70.3
2016,G,DENVER,1340516524,1402,343,1745,1185,67.91
2016,G,DENVER,1340516525,1200,386,1586,921,58.07
2016,G,DENVER,1340516526,733,262,995,473,47.54
2016,G,DENVER,1340516527,1933,672,2605,1351,51.86
2016,G,DENVER,1340516528,1990,459,2449,1621,66.19
2016,G,DENVER,1340516529,1492,348,1840,1294,70.33
2016,G,DENVER,1340516531,1618,261,1879,1129,60.09
2016,G,DENVER,1340816809,1019,256,1275,705,55.29
2016,G,DOLORES,3065817001,213,58,271,168,61.99
2016,G,DOLORES,3065817002,307,46,353,272,77.05
2016,G,DOLORES,3065817003,353,46,399,327,81.95
2016,G,DOLORES,3065817004,574,106,680,514,75.59
2016,G,DOUGLAS,4043918106,272,30,302,242,80.13
2016,G,DOUGLAS,4043918107,777,45,822,705,85.77
2016,G,DOUGLAS,4043918306,1050,62,1112,960,86.33
2016,G,DOUGLAS,4043918317,825,56,881,754,85.58
2016,G,DOUGLAS,4043918332,1933,136,2069,1735,83.86
2016,G,DOUGLAS,4043918345,1132,112,1244,1028,82.64
2016,G,DOUGLAS,4043918346,987,59,1046,914,87.38
2016,G,DOUGLAS,4043918401,1298,105,1403,1184,84.39
2016,G,DOUGLAS,4043918402,549,45,594,511,86.03
2016,G,DOUGLAS,4043918403,240,33,273,206,75.46
2016,G,DOUGLAS,4043918404,1539,127,1666,1430,85.83
2016,G,DOUGLAS,4043918405,1491,127,1618,1376,85.04
2016,G,DOUGLAS,4043918406,831,83,914,745,81.51
2016,G,DOUGLAS,4043918508,1687,138,1825,1538,84.27
2016,G,DOUGLAS,4043918511,1064,118,1182,966,81.73
2016,G,DOUGLAS,4043918512,1362,99,1461,1203,82.34
2016,G,DOUGLAS,4044418302,1637,223,1860,1448,77.85
2016,G,DOUGLAS,4044418303,986,202,1188,843,70.96
2016,G,DOUGLAS,4044418304,1375,325,1700,1118,65.76
2016,G,DOUGLAS,4044418309,1506,362,1868,1296,69.38
2016,G,DOUGLAS,4044418315,1707,172,1879,1526,81.21
2016,G,DOUGLAS,4044418316,2180,447,2627,1843,70.16
2016,G,DOUGLAS,4044418318,1247,140,1387,1140,82.19
2016,G,DOUGLAS,4044418319,1071,154,1225,949,77.47
2016,G,DOUGLAS,4044418320,1132,126,1258,999,79.41
2016,G,DOUGLAS,4044418321,1024,78,1102,899,81.58
2016,G,DOUGLAS,4044418322,1444,266,1710,1251,73.16
2016,G,DOUGLAS,4044418323,1053,106,1159,946,81.62
2016,G,DOUGLAS,4044418324,1532,148,1680,1369,81.49
2016,G,DOUGLAS,4044418325,1132,120,1252,1030,82.27
2016,G,DOUGLAS,4044418326,2024,219,2243,1856,82.75
2016,G,DOUGLAS,4044418327,2000,141,2141,1809,84.49
2016,G,DOUGLAS,4044418328,1145,112,1257,1024,81.46
2016,G,DOUGLAS,4044418329,1963,174,2137,1761,82.41
2016,G,DOUGLAS,4044418330,1743,166,1909,1617,84.7
2016,G,DOUGLAS,4044418331,1474,164,1638,1365,83.33
2016,G,DOUGLAS,4044418334,1765,218,1983,1574,79.37
2016,G,DOUGLAS,4044418350,1475,211,1686,1238,73.43
2016,G,DOUGLAS,4044418352,1284,110,1394,1172,84.07
2016,G,DOUGLAS,4044418353,1253,159,1412,1098,77.76
2016,G,DOUGLAS,4044518108,1149,129,1278,1000,78.25
2016,G,DOUGLAS,4044518109,1547,168,1715,1370,79.88
2016,G,DOUGLAS,4044518110,1652,204,1856,1426,76.83
2016,G,DOUGLAS,4044518111,1160,140,1300,1063,81.77
2016,G,DOUGLAS,4044518112,1499,175,1674,1349,80.59
2016,G,DOUGLAS,4044518113,1661,132,1793,1523,84.94
2016,G,DOUGLAS,4044518114,1949,168,2117,1784,84.27
2016,G,DOUGLAS,4044518116,2099,305,2404,1824,75.87
2016,G,DOUGLAS,4044518117,1490,177,1667,1318,79.06
2016,G,DOUGLAS,4044518261,1533,117,1650,1412,85.58
2016,G,DOUGLAS,4044518262,1475,196,1671,1336,79.95
2016,G,DOUGLAS,4044518263,1964,167,2131,1804,84.66
2016,G,DOUGLAS,4044518264,1983,408,2391,1692,70.77
2016,G,DOUGLAS,4044518333,1079,106,1185,970,81.86
2016,G,DOUGLAS,4044518335,671,65,736,621,84.38
2016,G,DOUGLAS,4044518336,1342,140,1482,1215,81.98
2016,G,DOUGLAS,4044518337,1170,221,1391,1005,72.25
2016,G,DOUGLAS,4044518338,1939,217,2156,1746,80.98
2016,G,DOUGLAS,4044518339,1969,262,2231,1748,78.35
2016,G,DOUGLAS,4044518340,1464,127,1591,1314,82.59
2016,G,DOUGLAS,4044518341,1298,123,1421,1198,84.31
2016,G,DOUGLAS,4044518342,1468,132,1600,1340,83.75
2016,G,DOUGLAS,4044518343,1520,170,1690,1355,80.18
2016,G,DOUGLAS,4044518344,1437,75,1512,1308,86.51
2016,G,DOUGLAS,4044518347,820,111,931,694,74.54
2016,G,DOUGLAS,4044518348,1681,223,1904,1507,79.15
2016,G,DOUGLAS,4044518349,1679,34,1713,1567,91.48
2016,G,DOUGLAS,4044518354,1506,120,1626,1357,83.46
2016,G,DOUGLAS,4044518501,2115,416,2531,1815,71.71
2016,G,DOUGLAS,4044518502,1360,175,1535,1165,75.9
2016,G,DOUGLAS,4044518503,1549,291,1840,1305,70.92
2016,G,DOUGLAS,4044518504,1632,179,1811,1461,80.67
2016,G,DOUGLAS,4044518505,1351,184,1535,1167,76.03
2016,G,DOUGLAS,4044518506,2096,326,2422,1831,75.6
2016,G,DOUGLAS,4044518507,1734,187,1921,1529,79.59
2016,G,DOUGLAS,4044518509,1493,100,1593,1362,85.5
2016,G,DOUGLAS,4044518510,1650,174,1824,1512,82.89
2016,G,DOUGLAS,4303918101,1065,84,1149,953,82.94
2016,G,DOUGLAS,4303918102,1449,161,1610,1299,80.68
2016,G,DOUGLAS,4303918103,1697,205,1902,1467,77.13
2016,G,DOUGLAS,4303918104,582,42,624,510,81.73
2016,G,DOUGLAS,4303918105,1947,135,2082,1789,85.93
2016,G,DOUGLAS,4303918115,1272,128,1400,1145,81.79
2016,G,DOUGLAS,4304418206,1031,92,1123,914,81.39
2016,G,DOUGLAS,4304418207,1260,193,1453,1073,73.85
2016,G,DOUGLAS,4304418208,1099,470,1569,899,57.3
2016,G,DOUGLAS,4304418232,1054,89,1143,995,87.05
2016,G,DOUGLAS,4304418233,1674,107,1781,1552,87.14
2016,G,DOUGLAS,4304418245,1912,193,2105,1761,83.66
2016,G,DOUGLAS,4304418257,1985,237,2222,1749,78.71
2016,G,DOUGLAS,4304418266,1623,120,1743,1465,84.05
2016,G,DOUGLAS,4304418301,2069,376,2445,1761,72.02
2016,G,DOUGLAS,4304418307,1414,221,1635,1228,75.11
2016,G,DOUGLAS,4304418308,1478,133,1611,1341,83.24
2016,G,DOUGLAS,4304418311,1311,226,1537,1154,75.08
2016,G,DOUGLAS,4304418312,1137,94,1231,1039,84.4
2016,G,DOUGLAS,4304418313,1042,78,1120,944,84.29
2016,G,DOUGLAS,4304418314,1010,88,1098,924,84.15
2016,G,DOUGLAS,4304418351,1358,59,1417,1250,88.21
2016,G,DOUGLAS,4304518258,1617,148,1765,1472,83.4
2016,G,DOUGLAS,4304518259,1613,92,1705,1454,85.28
2016,G,DOUGLAS,4304518260,1904,163,2067,1763,85.29
2016,G,DOUGLAS,6043918305,1071,57,1128,995,88.21
2016,G,DOUGLAS,6043918310,743,45,788,684,86.8
2016,G,DOUGLAS,6303918243,1649,112,1761,1501,85.24
2016,G,DOUGLAS,6303918247,1394,117,1511,1285,85.04
2016,G,DOUGLAS,6303918249,1393,134,1527,1279,83.76
2016,G,DOUGLAS,6303918250,1128,146,1274,1011,79.36
2016,G,DOUGLAS,6303918251,942,158,1100,841,76.45
2016,G,DOUGLAS,6303918252,1529,181,1710,1323,77.37
2016,G,DOUGLAS,6303918253,856,92,948,788,83.12
2016,G,DOUGLAS,6303918254,1964,193,2157,1778,82.43
2016,G,DOUGLAS,6303918255,1055,146,1201,950,79.1
2016,G,DOUGLAS,6303918256,895,65,960,808,84.17
2016,G,DOUGLAS,6303918265,1002,45,1047,911,87.01
2016,G,DOUGLAS,6304318201,1872,141,2013,1710,84.95
2016,G,DOUGLAS,6304318202,1640,225,1865,1461,78.34
2016,G,DOUGLAS,6304318203,1365,103,1468,1205,82.08
2016,G,DOUGLAS,6304318204,1192,286,1478,985,66.64
2016,G,DOUGLAS,6304318205,1765,343,2108,1543,73.2
2016,G,DOUGLAS,6304318209,1449,119,1568,1317,83.99
2016,G,DOUGLAS,6304318210,1957,278,2235,1750,78.3
2016,G,DOUGLAS,6304318211,1478,137,1615,1331,82.41
2016,G,DOUGLAS,6304318212,1332,125,1457,1206,82.77
2016,G,DOUGLAS,6304318213,1171,54,1225,1084,88.49
2016,G,DOUGLAS,6304318214,713,73,786,654,83.21
2016,G,DOUGLAS,6304318215,1157,87,1244,1039,83.52
2016,G,DOUGLAS,6304318216,857,81,938,801,85.39
2016,G,DOUGLAS,6304318217,1163,110,1273,1018,79.97
2016,G,DOUGLAS,6304318218,1062,64,1126,998,88.63
2016,G,DOUGLAS,6304318219,1004,85,1089,901,82.74
2016,G,DOUGLAS,6304318220,1048,89,1137,972,85.49
2016,G,DOUGLAS,6304318221,935,59,994,847,85.21
2016,G,DOUGLAS,6304318222,1408,171,1579,1255,79.48
2016,G,DOUGLAS,6304318223,1713,188,1901,1556,81.85
2016,G,DOUGLAS,6304318224,1598,112,1710,1437,84.04
2016,G,DOUGLAS,6304318225,1914,238,2152,1652,76.77
2016,G,DOUGLAS,6304318226,1240,93,1333,1130,84.77
2016,G,DOUGLAS,6304318227,1886,138,2024,1746,86.26
2016,G,DOUGLAS,6304318228,974,71,1045,869,83.16
2016,G,DOUGLAS,6304318229,1184,112,1296,1065,82.18
2016,G,DOUGLAS,6304318230,1061,103,1164,968,83.16
2016,G,DOUGLAS,6304318231,1438,148,1586,1295,81.65
2016,G,DOUGLAS,6304318234,1003,66,1069,920,86.06
2016,G,DOUGLAS,6304318235,1645,156,1801,1498,83.18
2016,G,DOUGLAS,6304318236,1885,169,2054,1721,83.79
2016,G,DOUGLAS,6304318237,1329,91,1420,1220,85.92
2016,G,DOUGLAS,6304318238,1293,92,1385,1173,84.69
2016,G,DOUGLAS,6304318239,1806,146,1952,1651,84.58
2016,G,DOUGLAS,6304318240,1245,264,1509,1075,71.24
2016,G,DOUGLAS,6304318241,1288,134,1422,1153,81.08
2016,G,DOUGLAS,6304318242,1040,117,1157,941,81.33
2016,G,DOUGLAS,6304318244,1403,120,1523,1265,83.06
2016,G,DOUGLAS,6304318246,1574,123,1697,1409,83.03
2016,G,DOUGLAS,6304318248,1051,90,1141,962,84.31
2016,G,EAGLE,2052619001,206,33,239,166,69.46
2016,G,EAGLE,2052619002,849,209,1058,683,64.56
2016,G,EAGLE,2052619003,776,144,920,632,68.7
2016,G,EAGLE,2052619011,706,195,901,558,61.93
2016,G,EAGLE,2052619012,1365,293,1658,1147,69.18
2016,G,EAGLE,2052619013,949,181,1130,788,69.73
2016,G,EAGLE,2052619014,672,131,803,575,71.61
2016,G,EAGLE,2052619015,1510,399,1909,1201,62.91
2016,G,EAGLE,2052619019,1449,217,1666,1217,73.05
2016,G,EAGLE,3052619004,999,79,1078,887,82.28
2016,G,EAGLE,3052619005,1858,229,2087,1597,76.52
2016,G,EAGLE,3052619006,858,113,971,721,74.25
2016,G,EAGLE,3052619007,1244,133,1377,1109,80.54
2016,G,EAGLE,3052619008,636,61,697,519,74.46
2016,G,EAGLE,3052619009,968,116,1084,816,75.28
2016,G,EAGLE,3052619010,168,13,181,158,87.29
2016,G,EAGLE,3052619016,626,53,679,552,81.3
2016,G,EAGLE,3052619017,920,147,1067,773,72.45
2016,G,EAGLE,3052619018,859,171,1030,695,67.48
2016,G,EAGLE,3052619020,1356,128,1484,1217,82.01
2016,G,EAGLE,3052619021,292,29,321,260,81
2016,G,EAGLE,3052619022,1323,209,1532,1018,66.45
2016,G,EAGLE,3052619023,1224,165,1389,995,71.63
2016,G,EAGLE,3052619024,1384,211,1595,1207,75.67
2016,G,EAGLE,3052619025,1256,78,1334,1113,83.43
2016,G,EAGLE,3052619026,1113,107,1220,991,81.23
2016,G,EAGLE,3052619027,1692,138,1830,1532,83.72
2016,G,EAGLE,3052619028,930,113,1043,826,79.19
2016,G,EAGLE,3052619029,1333,206,1539,1127,73.23
2016,G,EAGLE,3052619030,989,117,1106,893,80.74
2016,G,EL PASO,5021821745,261,37,298,245,82.21
2016,G,EL PASO,5021921452,1530,187,1717,1332,77.58
2016,G,EL PASO,5021921500,365,42,407,321,78.87
2016,G,EL PASO,5021921501,1036,155,1191,896,75.23
2016,G,EL PASO,5021921502,832,100,932,739,79.29
2016,G,EL PASO,5021921521,1170,233,1403,992,70.71
2016,G,EL PASO,5021921522,1319,167,1486,1134,76.31
2016,G,EL PASO,5021921523,1097,153,1250,974,77.92
2016,G,EL PASO,5021921524,1456,139,1595,1317,82.57
2016,G,EL PASO,5021921554,146,20,166,125,75.3
2016,G,EL PASO,5021921560,1209,188,1397,1024,73.3
2016,G,EL PASO,5021921653,198,18,216,172,79.63
2016,G,EL PASO,5021921828,514,77,591,432,73.1
2016,G,EL PASO,5022021740,1924,267,2191,1717,78.37
2016,G,EL PASO,5022121632,1914,538,2452,1485,60.56
2016,G,EL PASO,5022121639,1901,409,2310,1489,64.46
2016,G,EL PASO,5022121652,919,109,1028,778,75.68
2016,G,EL PASO,5022121801,2230,601,2831,1704,60.19
2016,G,EL PASO,5022121802,1524,297,1821,1186,65.13
2016,G,EL PASO,5022121803,1750,451,2201,1372,62.34
2016,G,EL PASO,5022121804,2074,436,2510,1640,65.34
2016,G,EL PASO,5022121805,1991,417,2408,1564,64.95
2016,G,EL PASO,5022121839,898,183,1081,753,69.66
2016,G,EL PASO,5091421215,1834,280,2114,1672,79.09
2016,G,EL PASO,5091421216,1688,238,1926,1518,78.82
2016,G,EL PASO,5091421217,1862,214,2076,1699,81.84
2016,G,EL PASO,5091421220,2323,332,2655,2128,80.15
2016,G,EL PASO,5091421221,1626,174,1800,1494,83
2016,G,EL PASO,5091421222,1894,194,2088,1726,82.66
2016,G,EL PASO,5091421223,2138,286,2424,1911,78.84
2016,G,EL PASO,5091421230,1602,170,1772,1484,83.75
2016,G,EL PASO,5091421231,1523,173,1696,1356,79.95
2016,G,EL PASO,5091421232,1572,223,1795,1405,78.27
2016,G,EL PASO,5091421233,1657,182,1839,1481,80.53
2016,G,EL PASO,5091421234,1591,198,1789,1457,81.44
2016,G,EL PASO,5091421236,2043,379,2422,1805,74.53
2016,G,EL PASO,5091421237,1965,333,2298,1690,73.54
2016,G,EL PASO,5091421238,1986,328,2314,1746,75.45
2016,G,EL PASO,5091521445,2025,224,2249,1798,79.95
2016,G,EL PASO,5091821107,1546,351,1897,1267,66.79
2016,G,EL PASO,5091821108,1266,127,1393,1138,81.69
2016,G,EL PASO,5091821109,217,28,245,186,75.92
2016,G,EL PASO,5091921209,1546,125,1671,1407,84.2
2016,G,EL PASO,5091921210,1568,204,1772,1432,80.81
2016,G,EL PASO,5091921211,1369,228,1597,1247,78.08
2016,G,EL PASO,5091921212,1683,155,1838,1572,85.53
2016,G,EL PASO,5091921213,1182,115,1297,1084,83.58
2016,G,EL PASO,5091921214,1618,153,1771,1500,84.7
2016,G,EL PASO,5091921218,1024,78,1102,913,82.85
2016,G,EL PASO,5091921219,1278,115,1393,1182,84.85
2016,G,EL PASO,5091921303,1847,213,2060,1673,81.21
2016,G,EL PASO,5091921310,1733,189,1922,1556,80.96
2016,G,EL PASO,5091921311,1812,152,1964,1671,85.08
2016,G,EL PASO,5091921312,1645,193,1838,1503,81.77
2016,G,EL PASO,5091921313,1726,230,1956,1551,79.29
2016,G,EL PASO,5091921314,1950,237,2187,1787,81.71
2016,G,EL PASO,5091921315,2091,267,2358,1938,82.19
2016,G,EL PASO,5091921316,1879,164,2043,1736,84.97
2016,G,EL PASO,5091921317,1876,153,2029,1734,85.46
2016,G,EL PASO,5091921320,1411,134,1545,1300,84.14
2016,G,EL PASO,5091921321,1819,163,1982,1705,86.02
2016,G,EL PASO,5091921322,1435,126,1561,1313,84.11
2016,G,EL PASO,5091921440,1597,142,1739,1438,82.69
2016,G,EL PASO,5091921441,1664,153,1817,1524,83.87
2016,G,EL PASO,5091921442,1651,206,1857,1478,79.59
2016,G,EL PASO,5091921443,1981,404,2385,1720,72.12
2016,G,EL PASO,5091921444,1605,173,1778,1454,81.78
2016,G,EL PASO,5091921446,2479,383,2862,2198,76.8
2016,G,EL PASO,5091921447,1954,315,2269,1692,74.57
2016,G,EL PASO,5091921525,235,14,249,217,87.15
2016,G,EL PASO,5092021101,1592,293,1885,1372,72.79
2016,G,EL PASO,5092021102,1748,163,1911,1633,85.45
2016,G,EL PASO,5092021103,1668,322,1990,1510,75.88
2016,G,EL PASO,5092021104,1857,341,2198,1696,77.16
2016,G,EL PASO,5092021105,1354,107,1461,1273,87.13
2016,G,EL PASO,5092021106,1612,426,2038,1386,68.01
2016,G,EL PASO,5092021116,1668,177,1845,1539,83.41
2016,G,EL PASO,5092021117,1519,347,1866,1254,67.2
2016,G,EL PASO,5092021200,761,348,1109,572,51.58
2016,G,EL PASO,5092021201,1806,139,1945,1647,84.68
2016,G,EL PASO,5092021202,1653,146,1799,1521,84.55
2016,G,EL PASO,5092021203,1447,137,1584,1335,84.28
2016,G,EL PASO,5092021204,1657,151,1808,1520,84.07
2016,G,EL PASO,5092021205,1681,265,1946,1502,77.18
2016,G,EL PASO,5092021206,2059,337,2396,1835,76.59
2016,G,EL PASO,5092021207,1972,322,2294,1783,77.72
2016,G,EL PASO,5092021208,1608,163,1771,1475,83.29
2016,G,EL PASO,5092021301,827,74,901,773,85.79
2016,G,EL PASO,5092021302,1845,250,2095,1676,80
2016,G,EL PASO,5092021741,479,44,523,437,83.56
2016,G,EL PASO,5101421141,1522,262,1784,1284,71.97
2016,G,EL PASO,5101421142,1824,243,2067,1624,78.57
2016,G,EL PASO,5101421143,2061,314,2375,1800,75.79
2016,G,EL PASO,5101421144,1426,192,1618,1237,76.45
2016,G,EL PASO,5101421145,1820,237,2057,1602,77.88
2016,G,EL PASO,5101421146,917,154,1071,821,76.66
2016,G,EL PASO,5101421163,2008,580,2588,1719,66.42
2016,G,EL PASO,5101421164,1536,243,1779,1333,74.93
2016,G,EL PASO,5101421235,1748,230,1978,1557,78.72
2016,G,EL PASO,5101421239,1599,325,1924,1384,71.93
2016,G,EL PASO,5101421240,1670,219,1889,1456,77.08
2016,G,EL PASO,5101421241,1919,309,2228,1667,74.82
2016,G,EL PASO,5101421242,1712,433,2145,1436,66.95
2016,G,EL PASO,5101421243,1720,384,2104,1507,71.63
2016,G,EL PASO,5101421244,1768,299,2067,1566,75.76
2016,G,EL PASO,5101421245,1651,246,1897,1499,79.02
2016,G,EL PASO,5101521159,386,48,434,331,76.27
2016,G,EL PASO,5101521401,2129,294,2423,1819,75.07
2016,G,EL PASO,5101521402,1736,403,2139,1471,68.77
2016,G,EL PASO,5101521403,1589,228,1817,1387,76.33
2016,G,EL PASO,5101521404,1814,448,2262,1478,65.34
2016,G,EL PASO,5101521405,1906,345,2251,1618,71.88
2016,G,EL PASO,5101521406,1964,394,2358,1657,70.27
2016,G,EL PASO,5101521407,1645,299,1944,1432,73.66
2016,G,EL PASO,5101521408,1571,254,1825,1394,76.38
2016,G,EL PASO,5101621120,1983,277,2260,1765,78.1
2016,G,EL PASO,5101621121,1883,343,2226,1632,73.32
2016,G,EL PASO,5101621122,1890,585,2475,1458,58.91
2016,G,EL PASO,5101621123,1939,310,2249,1596,70.96
2016,G,EL PASO,5101621124,2240,460,2700,1886,69.85
2016,G,EL PASO,5101621125,1841,251,2092,1608,76.86
2016,G,EL PASO,5101621126,1898,264,2162,1554,71.88
2016,G,EL PASO,5101621127,1867,200,2067,1635,79.1
2016,G,EL PASO,5101621128,1700,217,1917,1515,79.03
2016,G,EL PASO,5101621129,1869,624,2493,1512,60.65
2016,G,EL PASO,5101621130,1509,242,1751,1291,73.73
2016,G,EL PASO,5101621131,1623,208,1831,1398,76.35
2016,G,EL PASO,5101621132,1483,116,1599,1310,81.93
2016,G,EL PASO,5101621140,1530,144,1674,1347,80.47
2016,G,EL PASO,5101621147,1532,327,1859,1308,70.36
2016,G,EL PASO,5101621148,1877,310,2187,1592,72.79
2016,G,EL PASO,5101621149,1762,262,2024,1600,79.05
2016,G,EL PASO,5101621150,1492,126,1618,1349,83.37
2016,G,EL PASO,5101621151,1712,203,1915,1526,79.69
2016,G,EL PASO,5101621152,1740,321,2061,1450,70.35
2016,G,EL PASO,5101621153,1776,252,2028,1539,75.89
2016,G,EL PASO,5101621154,1721,558,2279,1355,59.46
2016,G,EL PASO,5101621157,1486,281,1767,1262,71.42
2016,G,EL PASO,5101621160,1726,293,2019,1486,73.6
2016,G,EL PASO,5101621165,1730,205,1935,1566,80.93
2016,G,EL PASO,5101621166,1690,512,2202,1320,59.95
2016,G,EL PASO,5101621175,2010,315,2325,1666,71.66
2016,G,EL PASO,5101821171,1286,178,1464,1160,79.23
2016,G,EL PASO,5101821174,1985,376,2361,1643,69.59
2016,G,EL PASO,5101821181,206,22,228,163,71.49
2016,G,EL PASO,5111721182,1535,321,1856,1153,62.12
2016,G,EL PASO,5111721183,1960,610,2570,1509,58.72
2016,G,EL PASO,5111721184,1962,886,2848,1353,47.51
2016,G,EL PASO,5111721187,1395,419,1814,1113,61.36
2016,G,EL PASO,5111721190,1580,609,2189,1199,54.77
2016,G,EL PASO,5111721193,1043,355,1398,812,58.08
2016,G,EL PASO,5111721194,946,305,1251,707,56.51
2016,G,EL PASO,5111721610,1180,485,1665,934,56.1
2016,G,EL PASO,5111721611,1659,444,2103,1270,60.39
2016,G,EL PASO,5111721612,1541,641,2182,1129,51.74
2016,G,EL PASO,5111721613,1661,385,2046,1259,61.53
2016,G,EL PASO,5111721614,1600,970,2570,1133,44.09
2016,G,EL PASO,5111721615,1026,250,1276,729,57.13
2016,G,EL PASO,5111721616,1400,320,1720,993,57.73
2016,G,EL PASO,5111721619,1905,1047,2952,1305,44.21
2016,G,EL PASO,5111721620,1934,393,2327,1551,66.65
2016,G,EL PASO,5111721621,1684,540,2224,1252,56.29
2016,G,EL PASO,5111721622,1752,586,2338,1244,53.21
2016,G,EL PASO,5111721623,1836,480,2316,1373,59.28
2016,G,EL PASO,5111721624,1588,355,1943,1131,58.21
2016,G,EL PASO,5111721625,1611,347,1958,1244,63.53
2016,G,EL PASO,5111821110,1550,361,1911,1304,68.24
2016,G,EL PASO,5111821111,2159,473,2632,1850,70.29
2016,G,EL PASO,5111821112,1645,372,2017,1360,67.43
2016,G,EL PASO,5111821113,1447,327,1774,1241,69.95
2016,G,EL PASO,5111821114,1539,241,1780,1373,77.13
2016,G,EL PASO,5111821118,1740,363,2103,1429,67.95
2016,G,EL PASO,5111821119,1471,312,1783,1257,70.5
2016,G,EL PASO,5111821168,1469,240,1709,1315,76.95
2016,G,EL PASO,5111821169,2008,715,2723,1504,55.23
2016,G,EL PASO,5111821170,1495,309,1804,1279,70.9
2016,G,EL PASO,5111821172,1428,188,1616,1265,78.28
2016,G,EL PASO,5111821173,1571,277,1848,1363,73.76
2016,G,EL PASO,5111821176,1984,1186,3170,1697,53.53
2016,G,EL PASO,5111821177,2033,895,2928,1623,55.43
2016,G,EL PASO,5111821178,1448,314,1762,1238,70.26
2016,G,EL PASO,5111821179,1509,219,1728,1342,77.66
2016,G,EL PASO,5111821180,1637,533,2170,1235,56.91
2016,G,EL PASO,5111821185,1374,427,1801,1053,58.47
2016,G,EL PASO,5111821186,1649,495,2144,1259,58.72
2016,G,EL PASO,5111821188,1562,387,1949,1250,64.14
2016,G,EL PASO,5111821742,1163,275,1438,1025,71.28
2016,G,EL PASO,5111821743,1319,289,1608,1150,71.52
2016,G,EL PASO,5111821744,1188,144,1332,1085,81.46
2016,G,EL PASO,5112021601,1196,322,1518,913,60.14
2016,G,EL PASO,5112021605,1321,340,1661,974,58.64
2016,G,EL PASO,5121521158,1626,232,1858,1423,76.59
2016,G,EL PASO,5121521161,1669,147,1816,1521,83.76
2016,G,EL PASO,5121521162,1362,186,1548,1178,76.1
2016,G,EL PASO,5121521167,1420,215,1635,1203,73.58
2016,G,EL PASO,5121521191,1800,336,2136,1524,71.35
2016,G,EL PASO,5121521192,1578,224,1802,1273,70.64
2016,G,EL PASO,5121521195,1394,336,1730,1100,63.58
2016,G,EL PASO,5121521196,1487,649,2136,1134,53.09
2016,G,EL PASO,5121521409,1458,187,1645,1304,79.27
2016,G,EL PASO,5121521410,1568,308,1876,1361,72.55
2016,G,EL PASO,5121521411,1683,278,1961,1476,75.27
2016,G,EL PASO,5121521412,1481,272,1753,1263,72.05
2016,G,EL PASO,5121521413,1974,387,2361,1654,70.06
2016,G,EL PASO,5121521414,1811,282,2093,1510,72.15
2016,G,EL PASO,5121521415,2200,422,2622,1791,68.31
2016,G,EL PASO,5121521416,1750,302,2052,1435,69.93
2016,G,EL PASO,5121521420,1780,187,1967,1572,79.92
2016,G,EL PASO,5121521421,2069,504,2573,1696,65.92
2016,G,EL PASO,5121521650,1653,338,1991,1317,66.15
2016,G,EL PASO,5121621155,1278,211,1489,1082,72.67
2016,G,EL PASO,5121621156,961,132,1093,835,76.4
2016,G,EL PASO,5121721631,514,146,660,366,55.45
2016,G,EL PASO,5121821115,945,240,1185,824,69.54
2016,G,EL PASO,5121821721,1531,116,1647,1400,85
2016,G,EL PASO,5121821722,1611,110,1721,1484,86.23
2016,G,EL PASO,5121821723,1779,445,2224,1507,67.76
2016,G,EL PASO,5121821724,1930,545,2475,1619,65.41
2016,G,EL PASO,5121921451,1326,198,1524,1155,75.79
2016,G,EL PASO,5121921453,1494,151,1645,1303,79.21
2016,G,EL PASO,5121921651,1152,222,1374,923,67.18
2016,G,EL PASO,5122021602,1266,175,1441,1118,77.59
2016,G,EL PASO,5122021603,1785,430,2215,1509,68.13
2016,G,EL PASO,5122021604,2153,1026,3179,1677,52.75
2016,G,EL PASO,5122021725,1917,286,2203,1707,77.49
2016,G,EL PASO,5122021726,1683,145,1828,1560,85.34
2016,G,EL PASO,5122021727,1616,143,1759,1487,84.54
2016,G,EL PASO,5122021728,1653,235,1888,1497,79.29
2016,G,EL PASO,5122021729,1868,251,2119,1702,80.32
2016,G,EL PASO,5122021730,1594,274,1868,1421,76.07
2016,G,EL PASO,5122121630,1541,254,1795,1231,68.58
2016,G,EL PASO,5122121633,1714,289,2003,1359,67.85
2016,G,EL PASO,5122121634,1729,220,1949,1403,71.99
2016,G,EL PASO,5122121635,1934,295,2229,1507,67.61
2016,G,EL PASO,5122121636,1924,262,2186,1532,70.08
2016,G,EL PASO,5122121637,1751,317,2068,1382,66.83
2016,G,EL PASO,5122121638,1844,272,2116,1451,68.57
2016,G,EL PASO,5122121640,1745,311,2056,1382,67.22
2016,G,EL PASO,5122121641,1494,224,1718,1232,71.71
2016,G,EL PASO,5122121642,1928,309,2237,1543,68.98
2016,G,EL PASO,5122121643,1959,334,2293,1550,67.6
2016,G,EL PASO,5122121800,1835,2024,3859,1202,31.15
2016,G,ELBERT,4016420001,815,108,923,690,74.76
2016,G,ELBERT,4016420002,1964,127,2091,1751,83.74
2016,G,ELBERT,4016420003,1270,96,1366,1134,83.02
2016,G,ELBERT,4016420004,1405,113,1518,1269,83.6
2016,G,ELBERT,4016420005,752,65,817,671,82.13
2016,G,ELBERT,4016420006,1557,125,1682,1389,82.58
2016,G,ELBERT,4016420007,1505,95,1600,1351,84.44
2016,G,ELBERT,4016420008,771,61,832,681,81.85
2016,G,ELBERT,4016420009,1172,96,1268,1050,82.81
2016,G,ELBERT,4016420010,1302,123,1425,1170,82.11
2016,G,ELBERT,4016420011,1069,95,1164,981,84.28
2016,G,ELBERT,4016420012,1289,139,1428,1124,78.71
2016,G,ELBERT,4016420013,993,82,1075,908,84.47
2016,G,ELBERT,4016420014,1408,138,1546,1241,80.27
2016,G,ELBERT,4016420015,991,107,1098,870,79.23
2016,G,FREMONT,5024722001,962,146,1108,838,75.63
2016,G,FREMONT,5024722002,1092,199,1291,885,68.55
2016,G,FREMONT,5024722003,1108,123,1231,956,77.66
2016,G,FREMONT,5024722025,232,23,255,177,69.41
2016,G,FREMONT,5024722026,480,49,529,408,77.13
2016,G,FREMONT,5024722028,250,27,277,216,77.98
2016,G,FREMONT,5026022004,951,161,1112,764,68.71
2016,G,FREMONT,5026022005,675,121,796,529,66.46
2016,G,FREMONT,5026022006,680,72,752,564,75
2016,G,FREMONT,5026022007,1473,238,1711,1258,73.52
2016,G,FREMONT,5026022008,784,101,885,642,72.54
2016,G,FREMONT,5026022009,1216,117,1333,1073,80.5
2016,G,FREMONT,5026022010,787,86,873,670,76.75
2016,G,FREMONT,5026022011,1481,157,1638,1349,82.36
2016,G,FREMONT,5026022012,1465,381,1846,1153,62.46
2016,G,FREMONT,5026022013,1016,183,1199,846,70.56
2016,G,FREMONT,5026022014,766,167,933,653,69.99
2016,G,FREMONT,5026022015,665,86,751,566,75.37
2016,G,FREMONT,5026022016,860,104,964,723,75
2016,G,FREMONT,5026022017,842,126,968,717,74.07
2016,G,FREMONT,5026022018,1213,183,1396,1008,72.21
2016,G,FREMONT,5026022019,1637,289,1926,1370,71.13
2016,G,FREMONT,5026022020,1325,225,1550,1072,69.16
2016,G,FREMONT,5026022021,697,84,781,620,79.39
2016,G,FREMONT,5026022022,1366,215,1581,1171,74.07
2016,G,FREMONT,5026022023,379,50,429,348,81.12
2016,G,FREMONT,5026022024,679,80,759,581,76.55
2016,G,FREMONT,5026022027,229,33,262,198,75.57
2016,G,FREMONT,5026022029,564,51,615,498,80.98
2016,G,FREMONT,5026022030,727,112,839,631,75.21
2016,G,GARFIELD,3085723001,1086,118,1204,909,75.5
2016,G,GARFIELD,3085723002,1949,170,2119,1749,82.54
2016,G,GARFIELD,3085723003,1378,159,1537,1185,77.1
2016,G,GARFIELD,3085723004,1602,139,1741,1433,82.31
2016,G,GARFIELD,3085723005,1470,182,1652,1276,77.24
2016,G,GARFIELD,3085723006,1045,145,1190,896,75.29
2016,G,GARFIELD,3085723007,826,121,947,706,74.55
2016,G,GARFIELD,3085723008,933,117,1050,791,75.33
2016,G,GARFIELD,3085723009,1016,128,1144,913,79.81
2016,G,GARFIELD,3085723010,1474,121,1595,1325,83.07
2016,G,GARFIELD,3085723011,914,74,988,833,84.31
2016,G,GARFIELD,3085723012,1199,122,1321,993,75.17
2016,G,GARFIELD,3085723013,768,93,861,616,71.54
2016,G,GARFIELD,3085723014,969,140,1109,845,76.19
2016,G,GARFIELD,3085723015,1998,193,2191,1752,79.96
2016,G,GARFIELD,3085723016,1511,134,1645,1309,79.57
2016,G,GARFIELD,3085723017,1258,116,1374,1122,81.66
2016,G,GARFIELD,3085723018,702,48,750,623,83.07
2016,G,GARFIELD,3085723019,1350,166,1516,1169,77.11
2016,G,GARFIELD,3085723020,1261,173,1434,1067,74.41
2016,G,GARFIELD,3085723021,1306,148,1454,1125,77.37
2016,G,GARFIELD,3085723022,1110,196,1306,887,67.92
2016,G,GARFIELD,3085723023,908,167,1075,742,69.02
2016,G,GARFIELD,3085723024,494,42,536,455,84.89
2016,G,GARFIELD,3085723025,631,88,719,530,73.71
2016,G,GARFIELD,3085723026,1213,185,1398,1097,78.47
2016,G,GARFIELD,3085723027,1001,160,1161,824,70.97
2016,G,GILPIN,2161324001,668,181,849,579,68.2
2016,G,GILPIN,2161324002,683,83,766,619,80.81
2016,G,GILPIN,2161324003,843,153,996,768,77.11
2016,G,GILPIN,2161324004,632,142,774,548,70.8
2016,G,GILPIN,2161324005,592,108,700,514,73.43
2016,G,GILPIN,2161324006,787,109,896,659,73.55
2016,G,GRAND,2081325001,754,114,868,652,75.12
2016,G,GRAND,2081325002,1141,153,1294,995,76.89
2016,G,GRAND,2081325003,1463,241,1704,1273,74.71
2016,G,GRAND,2081325004,711,85,796,608,76.38
2016,G,GRAND,2081325005,951,117,1068,804,75.28
2016,G,GRAND,2081325006,659,107,766,542,70.76
2016,G,GRAND,2081325007,977,181,1158,809,69.86
2016,G,GRAND,2081325008,721,72,793,627,79.07
2016,G,GRAND,2081325009,630,90,720,541,75.14
2016,G,GRAND,2081325010,760,98,858,671,78.21
2016,G,GRAND,2081325011,650,73,723,546,75.52
2016,G,GRAND,2081325012,869,113,982,779,79.33
2016,G,GUNNISON,3055926008,774,91,865,668,77.23
2016,G,GUNNISON,3055926009,879,165,1044,752,72.03
2016,G,GUNNISON,3055926010,728,284,1012,556,54.94
2016,G,GUNNISON,3055926012,214,30,244,180,73.77
2016,G,GUNNISON,3055926013,1172,134,1306,1049,80.32
2016,G,GUNNISON,3055926014,1150,272,1422,948,66.67
2016,G,GUNNISON,3055926015,514,127,641,414,64.59
2016,G,GUNNISON,3056126001,94,29,123,66,53.66
2016,G,GUNNISON,3056126002,272,30,302,218,72.19
2016,G,GUNNISON,3056126003,1346,189,1535,1159,75.5
2016,G,GUNNISON,3056126004,766,118,884,646,73.08
2016,G,GUNNISON,3056126005,1669,181,1850,1484,80.22
2016,G,GUNNISON,3056126006,759,102,861,642,74.56
2016,G,GUNNISON,3056126007,721,68,789,657,83.27
2016,G,GUNNISON,3056126011,343,42,385,299,77.66
2016,G,HINSDALE,3055927001,685,59,744,611,82.12
2016,G,HUERFANO,3356228001,385,41,426,345,80.99
2016,G,HUERFANO,3356228002,697,62,759,616,81.16
2016,G,HUERFANO,3356228003,497,47,544,417,76.65
2016,G,HUERFANO,3356228004,686,78,764,558,73.04
2016,G,HUERFANO,3356228005,194,22,216,176,81.48
2016,G,HUERFANO,3356228006,562,118,680,470,69.12
2016,G,HUERFANO,3356228007,223,42,265,186,70.19
2016,G,HUERFANO,3356228008,99,13,112,72,64.29
2016,G,HUERFANO,3356228009,640,67,707,549,77.65
2016,G,HUERFANO,3356228010,441,44,485,393,81.03
2016,G,HUERFANO,3356228011,132,15,147,120,81.63
2016,G,JACKSON,3081329001,368,74,442,323,73.08
2016,G,JACKSON,3081329002,72,16,88,60,68.18
2016,G,JACKSON,3081329003,121,21,142,118,83.1
2016,G,JACKSON,3081329004,62,9,71,54,76.06
2016,G,JACKSON,3081329005,371,95,466,330,70.82
2016,G,JEFFERSON,1160130001,212,6,218,193,88.53
2016,G,JEFFERSON,1162230002,1201,192,1393,1014,72.79
2016,G,JEFFERSON,1162230003,1297,87,1384,1171,84.61
2016,G,JEFFERSON,1162230004,1723,143,1866,1501,80.44
2016,G,JEFFERSON,1162230005,1502,96,1598,1331,83.29
2016,G,JEFFERSON,1162230006,1637,102,1739,1480,85.11
2016,G,JEFFERSON,1162230007,1738,140,1878,1506,80.19
2016,G,JEFFERSON,1162230008,1578,175,1753,1374,78.38
2016,G,JEFFERSON,1162230009,1715,95,1810,1571,86.8
2016,G,JEFFERSON,1162230010,859,39,898,776,86.41
2016,G,JEFFERSON,1162230011,1092,76,1168,957,81.93
2016,G,JEFFERSON,1162230012,1736,133,1869,1591,85.13
2016,G,JEFFERSON,1162230013,832,89,921,718,77.96
2016,G,JEFFERSON,1162230014,1205,86,1291,1046,81.02
2016,G,JEFFERSON,1202230015,400,55,455,342,75.16
2016,G,JEFFERSON,1222230016,1808,272,2080,1565,75.24
2016,G,JEFFERSON,1222230017,1044,115,1159,928,80.07
2016,G,JEFFERSON,1222230018,1656,123,1779,1512,84.99
2016,G,JEFFERSON,1222230019,1812,151,1963,1642,83.65
2016,G,JEFFERSON,1222230020,1847,169,2016,1662,82.44
2016,G,JEFFERSON,1222230021,1713,106,1819,1540,84.66
2016,G,JEFFERSON,1222230022,1197,83,1280,1054,82.34
2016,G,JEFFERSON,1222230023,1685,98,1783,1522,85.36
2016,G,JEFFERSON,1222230024,1702,130,1832,1532,83.62
2016,G,JEFFERSON,1222230025,1405,90,1495,1221,81.67
2016,G,JEFFERSON,1222230026,1853,164,2017,1648,81.71
2016,G,JEFFERSON,1222230027,1562,102,1664,1413,84.92
2016,G,JEFFERSON,1222230028,1100,168,1268,921,72.63
2016,G,JEFFERSON,1222230029,1541,169,1710,1362,79.65
2016,G,JEFFERSON,1222230030,1730,182,1912,1562,81.69
2016,G,JEFFERSON,1222230031,1289,105,1394,1115,79.99
2016,G,JEFFERSON,1222230032,1413,213,1626,1219,74.97
2016,G,JEFFERSON,1222230033,1885,182,2067,1647,79.68
2016,G,JEFFERSON,1222230034,1851,184,2035,1636,80.39
2016,G,JEFFERSON,1222230035,1202,103,1305,1046,80.15
2016,G,JEFFERSON,2162530036,1745,184,1929,1575,81.65
2016,G,JEFFERSON,2162530037,1165,104,1269,1072,84.48
2016,G,JEFFERSON,2162530038,1292,106,1398,1156,82.69
2016,G,JEFFERSON,2162530039,1362,128,1490,1235,82.89
2016,G,JEFFERSON,2162530040,1665,132,1797,1521,84.64
2016,G,JEFFERSON,2162530041,1007,75,1082,933,86.23
2016,G,JEFFERSON,2162530042,1237,124,1361,1123,82.51
2016,G,JEFFERSON,2162530043,827,77,904,748,82.74
2016,G,JEFFERSON,2162530044,1034,145,1179,906,76.84
2016,G,JEFFERSON,2162530045,1135,73,1208,1018,84.27
2016,G,JEFFERSON,2162530046,1130,156,1286,994,77.29
2016,G,JEFFERSON,2162530047,1179,125,1304,1075,82.44
2016,G,JEFFERSON,2162530048,1284,143,1427,1159,81.22
2016,G,JEFFERSON,2162530049,1202,101,1303,1088,83.5
2016,G,JEFFERSON,2162530050,1141,117,1258,1026,81.56
2016,G,JEFFERSON,2162530051,1402,164,1566,1261,80.52
2016,G,JEFFERSON,2162530052,1302,140,1442,1167,80.93
2016,G,JEFFERSON,2162530053,1003,83,1086,907,83.52
2016,G,JEFFERSON,2162530054,1243,94,1337,1145,85.64
2016,G,JEFFERSON,2162530055,616,75,691,521,75.4
2016,G,JEFFERSON,2162530056,1036,109,1145,963,84.1
2016,G,JEFFERSON,2162530057,1296,123,1419,1134,79.92
2016,G,JEFFERSON,2162530058,1702,137,1839,1540,83.74
2016,G,JEFFERSON,2162530059,1314,141,1455,1165,80.07
2016,G,JEFFERSON,2162530060,592,67,659,517,78.45
2016,G,JEFFERSON,2162530061,1321,164,1485,1170,78.79
2016,G,JEFFERSON,2162530062,1416,144,1560,1287,82.5
2016,G,JEFFERSON,2162530063,1133,105,1238,1034,83.52
2016,G,JEFFERSON,2162530064,590,32,622,540,86.82
2016,G,JEFFERSON,2162530065,1380,128,1508,1227,81.37
2016,G,JEFFERSON,2162530066,1281,101,1382,1173,84.88
2016,G,JEFFERSON,2162530067,1184,156,1340,1037,77.39
2016,G,JEFFERSON,2162530068,974,59,1033,866,83.83
2016,G,JEFFERSON,2202230069,595,82,677,514,75.92
2016,G,JEFFERSON,2202530070,1812,137,1949,1570,80.55
2016,G,JEFFERSON,2202530071,1667,141,1808,1457,80.59
2016,G,JEFFERSON,2202530072,1795,184,1979,1527,77.16
2016,G,JEFFERSON,2202530073,1646,136,1782,1448,81.26
2016,G,JEFFERSON,2202530074,1705,149,1854,1500,80.91
2016,G,JEFFERSON,2202530075,1734,262,1996,1515,75.9
2016,G,JEFFERSON,2202530076,1616,129,1745,1462,83.78
2016,G,JEFFERSON,2202530077,1520,82,1602,1414,88.26
2016,G,JEFFERSON,2202530078,1344,81,1425,1232,86.46
2016,G,JEFFERSON,2202530079,850,41,891,782,87.77
2016,G,JEFFERSON,2202530080,1234,103,1337,1117,83.55
2016,G,JEFFERSON,2222230081,1523,95,1618,1374,84.92
2016,G,JEFFERSON,2222230082,1308,66,1374,1167,84.93
2016,G,JEFFERSON,2222530083,935,52,987,859,87.03
2016,G,JEFFERSON,7162430084,1672,296,1968,1337,67.94
2016,G,JEFFERSON,7162430085,1675,321,1996,1388,69.54
2016,G,JEFFERSON,7162430086,1534,145,1679,1429,85.11
2016,G,JEFFERSON,7162430087,927,98,1025,844,82.34
2016,G,JEFFERSON,7162430088,1733,293,2026,1459,72.01
2016,G,JEFFERSON,7162430089,1362,318,1680,1128,67.14
2016,G,JEFFERSON,7162430090,1677,407,2084,1357,65.12
2016,G,JEFFERSON,7162430091,1530,77,1607,1413,87.93
2016,G,JEFFERSON,7162430092,1187,72,1259,1099,87.29
2016,G,JEFFERSON,7162430093,1664,284,1948,1494,76.69
2016,G,JEFFERSON,7162430094,1271,252,1523,1102,72.36
2016,G,JEFFERSON,7162430095,1331,164,1495,1185,79.26
2016,G,JEFFERSON,7162530096,140,12,152,121,79.61
2016,G,JEFFERSON,7162530097,362,37,399,333,83.46
2016,G,JEFFERSON,7192430098,1017,66,1083,928,85.69
2016,G,JEFFERSON,7192730099,1821,80,1901,1699,89.37
2016,G,JEFFERSON,7192730100,1968,148,2116,1809,85.49
2016,G,JEFFERSON,7192730101,1971,154,2125,1756,82.64
2016,G,JEFFERSON,7192730102,1296,95,1391,1162,83.54
2016,G,JEFFERSON,7192730103,1724,116,1840,1615,87.77
2016,G,JEFFERSON,7192730104,1257,132,1389,1087,78.26
2016,G,JEFFERSON,7192730105,1436,203,1639,1234,75.29
2016,G,JEFFERSON,7192730106,1982,160,2142,1769,82.59
2016,G,JEFFERSON,7192730107,1687,117,1804,1527,84.65
2016,G,JEFFERSON,7192730108,1346,127,1473,1185,80.45
2016,G,JEFFERSON,7192730109,1442,127,1569,1244,79.29
2016,G,JEFFERSON,7192730110,1545,90,1635,1380,84.4
2016,G,JEFFERSON,7192730111,1941,175,2116,1705,80.58
2016,G,JEFFERSON,7192730112,1548,190,1738,1318,75.83
2016,G,JEFFERSON,7192730113,1440,93,1533,1330,86.76
2016,G,JEFFERSON,7192730114,1746,162,1908,1560,81.76
2016,G,JEFFERSON,7192730115,1816,135,1951,1649,84.52
2016,G,JEFFERSON,7192730116,1554,93,1647,1429,86.76
2016,G,JEFFERSON,7192730117,1689,134,1823,1521,83.43
2016,G,JEFFERSON,7192730118,1780,82,1862,1626,87.33
2016,G,JEFFERSON,7192730119,2027,334,2361,1658,70.22
2016,G,JEFFERSON,7192730120,2107,437,2544,1750,68.79
2016,G,JEFFERSON,7192730121,1591,246,1837,1346,73.27
2016,G,JEFFERSON,7192730122,2028,245,2273,1686,74.18
2016,G,JEFFERSON,7192730123,1795,150,1945,1588,81.65
2016,G,JEFFERSON,7192730124,1873,237,2110,1574,74.6
2016,G,JEFFERSON,7192730125,1413,223,1636,1155,70.6
2016,G,JEFFERSON,7192730126,1887,178,2065,1667,80.73
2016,G,JEFFERSON,7192930127,1599,159,1758,1413,80.38
2016,G,JEFFERSON,7192930128,1957,335,2292,1657,72.29
2016,G,JEFFERSON,7192930129,1301,132,1433,1111,77.53
2016,G,JEFFERSON,7192930130,1377,124,1501,1163,77.48
2016,G,JEFFERSON,7192930131,1326,168,1494,1130,75.64
2016,G,JEFFERSON,7192930132,1387,100,1487,1208,81.24
2016,G,JEFFERSON,7192930133,1938,529,2467,1610,65.26
2016,G,JEFFERSON,7192930134,1342,130,1472,1172,79.62
2016,G,JEFFERSON,7192930135,962,74,1036,866,83.59
2016,G,JEFFERSON,7192930136,1754,118,1872,1562,83.44
2016,G,JEFFERSON,7192930137,1812,166,1978,1555,78.61
2016,G,JEFFERSON,7192930138,1371,132,1503,1203,80.04
2016,G,JEFFERSON,7192930139,1601,184,1785,1347,75.46
2016,G,JEFFERSON,7192930140,1501,171,1672,1284,76.79
2016,G,JEFFERSON,7192930141,1779,229,2008,1560,77.69
2016,G,JEFFERSON,7192930142,1863,281,2144,1656,77.24
2016,G,JEFFERSON,7192930143,1600,155,1755,1391,79.26
2016,G,JEFFERSON,7192930144,1240,123,1363,1082,79.38
2016,G,JEFFERSON,7192930145,1341,156,1497,1118,74.68
2016,G,JEFFERSON,7192930146,2174,380,2554,1731,67.78
2016,G,JEFFERSON,7192930147,2010,252,2262,1674,74.01
2016,G,JEFFERSON,7192930148,1896,176,2072,1629,78.62
2016,G,JEFFERSON,7192930149,1787,167,1954,1514,77.48
2016,G,JEFFERSON,7192930150,1441,117,1558,1210,77.66
2016,G,JEFFERSON,7192930151,1954,180,2134,1654,77.51
2016,G,JEFFERSON,7192930152,1583,136,1719,1441,83.83
2016,G,JEFFERSON,7192930153,1919,300,2219,1622,73.1
2016,G,JEFFERSON,7192930154,1812,213,2025,1523,75.21
2016,G,JEFFERSON,7192930155,1746,169,1915,1505,78.59
2016,G,JEFFERSON,7192930156,1641,169,1810,1419,78.4
2016,G,JEFFERSON,7192930157,1509,177,1686,1264,74.97
2016,G,JEFFERSON,7202330158,1691,241,1932,1449,75
2016,G,JEFFERSON,7202330159,1967,331,2298,1609,70.02
2016,G,JEFFERSON,7202330160,1519,316,1835,1164,63.43
2016,G,JEFFERSON,7202330161,1029,150,1179,835,70.82
2016,G,JEFFERSON,7202330162,1270,142,1412,1079,76.42
2016,G,JEFFERSON,7202330163,1501,234,1735,1272,73.31
2016,G,JEFFERSON,7202330164,1768,89,1857,1610,86.7
2016,G,JEFFERSON,7202330165,1743,146,1889,1580,83.64
2016,G,JEFFERSON,7202330166,1767,159,1926,1558,80.89
2016,G,JEFFERSON,7202330167,1083,319,1402,878,62.62
2016,G,JEFFERSON,7202330168,998,73,1071,878,81.98
2016,G,JEFFERSON,7202330169,1404,77,1481,1260,85.08
2016,G,JEFFERSON,7202330170,1612,76,1688,1469,87.03
2016,G,JEFFERSON,7202330171,1841,145,1986,1659,83.53
2016,G,JEFFERSON,7202330172,1697,242,1939,1491,76.9
2016,G,JEFFERSON,7202330173,1807,491,2298,1484,64.58
2016,G,JEFFERSON,7202330174,1786,160,1946,1539,79.09
2016,G,JEFFERSON,7202330175,1858,197,2055,1580,76.89
2016,G,JEFFERSON,7202330176,1466,78,1544,1323,85.69
2016,G,JEFFERSON,7202330177,1916,193,2109,1693,80.28
2016,G,JEFFERSON,7202330178,1844,303,2147,1569,73.08
2016,G,JEFFERSON,7202330179,1825,256,2081,1618,77.75
2016,G,JEFFERSON,7202330180,1011,158,1169,853,72.97
2016,G,JEFFERSON,7202330181,1671,160,1831,1457,79.57
2016,G,JEFFERSON,7202430182,1729,89,1818,1559,85.75
2016,G,JEFFERSON,7202430183,1361,58,1419,1256,88.51
2016,G,JEFFERSON,7202430184,1783,183,1966,1569,79.81
2016,G,JEFFERSON,7202430185,1519,139,1658,1344,81.06
2016,G,JEFFERSON,7202430186,1788,232,2020,1591,78.76
2016,G,JEFFERSON,7202430187,1289,82,1371,1175,85.7
2016,G,JEFFERSON,7202430188,1285,162,1447,1069,73.88
2016,G,JEFFERSON,7202430189,1869,142,2011,1656,82.35
2016,G,JEFFERSON,7202430190,1166,97,1263,1017,80.52
2016,G,JEFFERSON,7202430191,1890,186,2076,1639,78.95
2016,G,JEFFERSON,7202430192,1647,162,1809,1443,79.77
2016,G,JEFFERSON,7202430193,1531,125,1656,1336,80.68
2016,G,JEFFERSON,7202430194,2091,289,2380,1755,73.74
2016,G,JEFFERSON,7202430195,2023,374,2397,1582,66
2016,G,JEFFERSON,7202430196,1473,163,1636,1327,81.11
2016,G,JEFFERSON,7202430197,1131,134,1265,977,77.23
2016,G,JEFFERSON,7202430198,2129,438,2567,1678,65.37
2016,G,JEFFERSON,7202430199,1214,83,1297,1115,85.97
2016,G,JEFFERSON,7202430200,1883,245,2128,1590,74.72
2016,G,JEFFERSON,7202430201,1701,129,1830,1502,82.08
2016,G,JEFFERSON,7202530202,1253,75,1328,1185,89.23
2016,G,JEFFERSON,7202530203,535,56,591,456,77.16
2016,G,JEFFERSON,7202530204,1377,100,1477,1206,81.65
2016,G,JEFFERSON,7202730205,1719,88,1807,1596,88.32
2016,G,JEFFERSON,7202730206,1381,84,1465,1258,85.87
2016,G,JEFFERSON,7202730207,1648,105,1753,1503,85.74
2016,G,JEFFERSON,7202730208,1743,90,1833,1631,88.98
2016,G,JEFFERSON,7202730209,1659,118,1777,1474,82.95
2016,G,JEFFERSON,7202730210,2017,91,2108,1881,89.23
2016,G,JEFFERSON,7202730211,2789,43,2832,2610,92.16
2016,G,JEFFERSON,7202830212,1592,87,1679,1453,86.54
2016,G,JEFFERSON,7202830213,1362,104,1466,1231,83.97
2016,G,JEFFERSON,7202830214,1858,109,1967,1685,85.66
2016,G,JEFFERSON,7202830215,2083,74,2157,1927,89.34
2016,G,JEFFERSON,7202830216,1625,390,2015,1402,69.58
2016,G,JEFFERSON,7202830217,1168,227,1395,1023,73.33
2016,G,JEFFERSON,7222230218,2072,123,2195,1900,86.56
2016,G,JEFFERSON,7222230219,880,56,936,795,84.94
2016,G,JEFFERSON,7222330220,1163,216,1379,944,68.46
2016,G,JEFFERSON,7222330221,1815,140,1955,1631,83.43
2016,G,JEFFERSON,7222330222,1217,246,1463,990,67.67
2016,G,JEFFERSON,7222330223,1485,114,1599,1321,82.61
2016,G,JEFFERSON,7222330224,1622,382,2004,1226,61.18
2016,G,JEFFERSON,7222330225,1281,257,1538,1025,66.64
2016,G,JEFFERSON,7222330226,2108,429,2537,1643,64.76
2016,G,JEFFERSON,7222330227,1899,475,2374,1475,62.13
2016,G,JEFFERSON,7222330228,2032,144,2176,1819,83.59
2016,G,JEFFERSON,7222330229,1758,360,2118,1507,71.15
2016,G,JEFFERSON,7222430230,1285,197,1482,1080,72.87
2016,G,JEFFERSON,7222430231,1658,301,1959,1365,69.68
2016,G,JEFFERSON,7222830232,1720,342,2062,1426,69.16
2016,G,JEFFERSON,7222830233,963,100,1063,843,79.3
2016,G,JEFFERSON,7222830234,1245,136,1381,1102,79.8
2016,G,JEFFERSON,7222830235,1545,105,1650,1367,82.85
2016,G,JEFFERSON,7222830236,1549,88,1637,1414,86.38
2016,G,JEFFERSON,7222830237,1386,306,1692,1178,69.62
2016,G,JEFFERSON,7222830238,1603,299,1902,1304,68.56
2016,G,JEFFERSON,7222830239,1339,184,1523,1123,73.74
2016,G,JEFFERSON,7222830240,1626,276,1902,1359,71.45
2016,G,JEFFERSON,7222830241,1436,199,1635,1122,68.62
2016,G,JEFFERSON,7222830242,1418,195,1613,1149,71.23
2016,G,JEFFERSON,7222830243,1362,110,1472,1185,80.5
2016,G,JEFFERSON,7222830244,1437,121,1558,1182,75.87
2016,G,JEFFERSON,7222830245,1809,182,1991,1466,73.63
2016,G,JEFFERSON,7222830246,1019,71,1090,899,82.48
2016,G,JEFFERSON,7222830247,1676,202,1878,1326,70.61
2016,G,JEFFERSON,7222830248,1399,247,1646,1094,66.46
2016,G,JEFFERSON,7222830249,1915,654,2569,1579,61.46
2016,G,JEFFERSON,7222830250,1395,125,1520,1226,80.66
2016,G,JEFFERSON,7222830251,2036,271,2307,1671,72.43
2016,G,JEFFERSON,7222830252,1912,145,2057,1655,80.46
2016,G,JEFFERSON,7222830253,1241,179,1420,1056,74.37
2016,G,JEFFERSON,7222830254,1558,126,1684,1356,80.52
2016,G,JEFFERSON,7222830255,1361,171,1532,1150,75.07
2016,G,JEFFERSON,7222830256,1959,151,2110,1700,80.57
2016,G,JEFFERSON,7222830257,1773,287,2060,1544,74.95
2016,G,JEFFERSON,7222830258,1380,217,1597,1162,72.76
2016,G,KIOWA,4356431001,179,18,197,160,81.22
2016,G,KIOWA,4356431002,287,27,314,267,85.03
2016,G,KIOWA,4356431003,389,41,430,367,85.35
2016,G,KIOWA,4356431004,85,3,88,81,92.05
2016,G,KIT CARSON,4016532001,400,72,472,332,70.34
2016,G,KIT CARSON,4016532002,322,75,397,269,67.76
2016,G,KIT CARSON,4016532003,458,100,558,390,69.89
2016,G,KIT CARSON,4016532004,332,46,378,303,80.16
2016,G,KIT CARSON,4016532005,469,87,556,420,75.54
2016,G,KIT CARSON,4016532006,339,40,379,300,79.16
2016,G,KIT CARSON,4016532007,305,36,341,270,79.18
2016,G,KIT CARSON,4016532008,287,44,331,251,75.83
2016,G,KIT CARSON,4016532009,386,42,428,338,78.97
2016,G,KIT CARSON,4016532010,176,10,186,148,79.57
2016,G,KIT CARSON,4016532011,256,36,292,230,78.77
2016,G,KIT CARSON,4016532012,259,37,296,232,78.38
2016,G,KIT CARSON,4016532013,303,38,341,279,81.82
2016,G,LA PLATA,3065934001,1021,360,1381,830,60.1
2016,G,LA PLATA,3065934002,772,216,988,623,63.06
2016,G,LA PLATA,3065934003,429,99,528,363,68.75
2016,G,LA PLATA,3065934004,1099,239,1338,965,72.12
2016,G,LA PLATA,3065934005,944,130,1074,841,78.31
2016,G,LA PLATA,3065934006,992,133,1125,862,76.62
2016,G,LA PLATA,3065934007,1317,311,1628,1116,68.55
2016,G,LA PLATA,3065934008,1133,179,1312,1011,77.06
2016,G,LA PLATA,3065934009,851,144,995,757,76.08
2016,G,LA PLATA,3065934010,667,172,839,590,70.32
2016,G,LA PLATA,3065934011,1503,207,1710,1306,76.37
2016,G,LA PLATA,3065934012,1323,200,1523,1132,74.33
2016,G,LA PLATA,3065934013,1744,314,2058,1524,74.05
2016,G,LA PLATA,3065934014,1405,213,1618,1280,79.11
2016,G,LA PLATA,3065934015,583,134,717,486,67.78
2016,G,LA PLATA,3065934016,900,173,1073,764,71.2
2016,G,LA PLATA,3065934017,1711,246,1957,1490,76.14
2016,G,LA PLATA,3065934018,1123,152,1275,983,77.1
2016,G,LA PLATA,3065934019,1740,235,1975,1528,77.37
2016,G,LA PLATA,3065934020,1394,259,1653,1197,72.41
2016,G,LA PLATA,3065934021,1332,182,1514,1145,75.63
2016,G,LA PLATA,3065934022,1324,215,1539,1117,72.58
2016,G,LA PLATA,3065934023,1501,191,1692,1278,75.53
2016,G,LA PLATA,3065934024,1144,208,1352,829,61.32
2016,G,LA PLATA,3065934025,478,68,546,428,78.39
2016,G,LA PLATA,3065934026,2263,491,2754,1954,70.95
2016,G,LA PLATA,3065934027,492,126,618,433,70.06
2016,G,LA PLATA,3065934028,1181,245,1426,1042,73.07
2016,G,LA PLATA,3065934029,1276,219,1495,1075,71.91
2016,G,LA PLATA,3065934030,2416,918,3334,1949,58.46
2016,G,LA PLATA,3065934031,578,74,652,510,78.22
2016,G,LA PLATA,3065934032,689,133,822,604,73.48
2016,G,LAKE,3056133001,760,250,1010,622,61.58
2016,G,LAKE,3056133002,665,221,886,539,60.84
2016,G,LAKE,3056133003,588,345,933,493,52.84
2016,G,LAKE,3056133004,667,264,931,542,58.22
2016,G,LAKE,3056133005,635,206,841,520,61.83
2016,G,LAKE,3056133006,790,215,1005,598,59.5
2016,G,LARIMER,2145235201,1591,322,1913,1285,67.17
2016,G,LARIMER,2145235202,1323,215,1538,1140,74.12
2016,G,LARIMER,2145235203,1241,129,1370,1103,80.51
2016,G,LARIMER,2145235204,1461,246,1707,1254,73.46
2016,G,LARIMER,2145235205,1158,297,1455,1005,69.07
2016,G,LARIMER,2145235206,1503,300,1803,1361,75.49
2016,G,LARIMER,2145235207,1168,322,1490,1042,69.93
2016,G,LARIMER,2145235208,1457,316,1773,1299,73.27
2016,G,LARIMER,2145235209,1393,235,1628,1243,76.35
2016,G,LARIMER,2145235210,1313,290,1603,1101,68.68
2016,G,LARIMER,2145235211,1163,189,1352,1019,75.37
2016,G,LARIMER,2145235212,1088,90,1178,995,84.47
2016,G,LARIMER,2145235213,1810,308,2118,1619,76.44
2016,G,LARIMER,2145235214,1350,222,1572,1218,77.48
2016,G,LARIMER,2145235215,1014,182,1196,906,75.75
2016,G,LARIMER,2145235216,900,185,1085,785,72.35
2016,G,LARIMER,2145235217,1454,132,1586,1307,82.41
2016,G,LARIMER,2145235218,2223,288,2511,2008,79.97
2016,G,LARIMER,2145235219,1523,145,1668,1397,83.75
2016,G,LARIMER,2145235220,1220,103,1323,1148,86.77
2016,G,LARIMER,2145235221,1357,259,1616,1165,72.09
2016,G,LARIMER,2145235222,1761,346,2107,1576,74.8
2016,G,LARIMER,2145235223,1413,195,1608,1288,80.1
2016,G,LARIMER,2145235224,1036,130,1166,935,80.19
2016,G,LARIMER,2145235225,1512,102,1614,1406,87.11
2016,G,LARIMER,2145235226,1992,336,2328,1657,71.18
2016,G,LARIMER,2145235227,1759,197,1956,1597,81.65
2016,G,LARIMER,2145235228,1275,107,1382,1155,83.57
2016,G,LARIMER,2145235229,1582,199,1781,1422,79.84
2016,G,LARIMER,2145235230,1224,98,1322,1122,84.87
2016,G,LARIMER,2145235231,1150,182,1332,1040,78.08
2016,G,LARIMER,2145235232,1161,87,1248,1066,85.42
2016,G,LARIMER,2145235233,1238,143,1381,1131,81.9
2016,G,LARIMER,2145235234,1182,89,1271,1103,86.78
2016,G,LARIMER,2145235235,1449,136,1585,1316,83.03
2016,G,LARIMER,2145235236,1785,112,1897,1656,87.3
2016,G,LARIMER,2145235237,1301,108,1409,1218,86.44
2016,G,LARIMER,2145235238,1048,95,1143,959,83.9
2016,G,LARIMER,2145235239,1075,197,1272,848,66.67
2016,G,LARIMER,2145235240,1180,147,1327,1063,80.11
2016,G,LARIMER,2145335301,1108,234,1342,982,73.17
2016,G,LARIMER,2145335302,1643,269,1912,1495,78.19
2016,G,LARIMER,2145335303,1304,201,1505,1154,76.68
2016,G,LARIMER,2145335304,1785,354,2139,1543,72.14
2016,G,LARIMER,2145335305,1564,321,1885,1391,73.79
2016,G,LARIMER,2145335306,1749,516,2265,1512,66.75
2016,G,LARIMER,2145335307,1871,515,2386,1615,67.69
2016,G,LARIMER,2145335308,1120,332,1452,897,61.78
2016,G,LARIMER,2145335309,1477,506,1983,1260,63.54
2016,G,LARIMER,2145335310,1824,272,2096,1595,76.1
2016,G,LARIMER,2145335311,1740,522,2262,1520,67.2
2016,G,LARIMER,2145335312,1552,366,1918,1321,68.87
2016,G,LARIMER,2145335313,1350,185,1535,1203,78.37
2016,G,LARIMER,2145335314,2080,420,2500,1819,72.76
2016,G,LARIMER,2145335315,1513,207,1720,1340,77.91
2016,G,LARIMER,2145335316,1004,89,1093,898,82.16
2016,G,LARIMER,2145335317,1419,81,1500,1323,88.2
2016,G,LARIMER,2145335318,1301,305,1606,1154,71.86
2016,G,LARIMER,2145335319,1189,163,1352,1043,77.14
2016,G,LARIMER,2145335320,1076,166,1242,948,76.33
2016,G,LARIMER,2145335321,1283,348,1631,1094,67.08
2016,G,LARIMER,2145335322,1318,180,1498,1156,77.17
2016,G,LARIMER,2145335323,1352,164,1516,1215,80.15
2016,G,LARIMER,2145335324,1575,91,1666,1453,87.21
2016,G,LARIMER,2145335325,1535,259,1794,1359,75.75
2016,G,LARIMER,2145335326,1820,246,2066,1585,76.72
2016,G,LARIMER,2145335327,1470,95,1565,1321,84.41
2016,G,LARIMER,2145335328,1483,93,1576,1358,86.17
2016,G,LARIMER,2145335329,1135,76,1211,1025,84.64
2016,G,LARIMER,2145335330,1361,114,1475,1251,84.81
2016,G,LARIMER,2145335331,860,82,942,757,80.36
2016,G,LARIMER,2145335332,1164,160,1324,1000,75.53
2016,G,LARIMER,2145335333,966,126,1092,871,79.76
2016,G,LARIMER,2145335334,1385,542,1927,1204,62.48
2016,G,LARIMER,2145335335,2042,612,2654,1749,65.9
2016,G,LARIMER,2145335336,1033,359,1392,875,62.86
2016,G,LARIMER,2154935401,651,112,763,579,75.88
2016,G,LARIMER,2154935402,1771,166,1937,1600,82.6
2016,G,LARIMER,2154935403,1249,106,1355,1121,82.73
2016,G,LARIMER,2154935404,113,14,127,101,79.53
2016,G,LARIMER,2154935405,733,69,802,653,81.42
2016,G,LARIMER,2154935406,932,68,1000,854,85.4
2016,G,LARIMER,2154935407,1701,139,1840,1532,83.26
2016,G,LARIMER,2154935408,1871,138,2009,1682,83.72
2016,G,LARIMER,2154935409,1192,114,1306,1082,82.85
2016,G,LARIMER,2154935410,966,149,1115,855,76.68
2016,G,LARIMER,2154935411,1423,132,1555,1315,84.57
2016,G,LARIMER,2154935412,926,163,1089,831,76.31
2016,G,LARIMER,2154935413,1258,143,1401,1132,80.8
2016,G,LARIMER,2154935414,1202,162,1364,1080,79.18
2016,G,LARIMER,2154935415,1339,233,1572,1207,76.78
2016,G,LARIMER,2154935416,1374,128,1502,1243,82.76
2016,G,LARIMER,2154935417,1144,99,1243,1061,85.36
2016,G,LARIMER,2154935418,1528,120,1648,1399,84.89
2016,G,LARIMER,2154935419,1471,119,1590,1304,82.01
2016,G,LARIMER,2154935420,1930,172,2102,1695,80.64
2016,G,LARIMER,2154935421,1713,151,1864,1531,82.14
2016,G,LARIMER,2154935422,1270,75,1345,1154,85.8
2016,G,LARIMER,2154935423,1424,93,1517,1323,87.21
2016,G,LARIMER,2154935424,40,2,42,37,88.1
2016,G,LARIMER,2154935425,173,11,184,155,84.24
2016,G,LARIMER,2154935426,1071,75,1146,976,85.17
2016,G,LARIMER,2154935427,1378,96,1474,1249,84.74
2016,G,LARIMER,2154935428,1246,99,1345,1126,83.72
2016,G,LARIMER,2154935429,1741,181,1922,1533,79.76
2016,G,LARIMER,2154935430,1009,69,1078,902,83.67
2016,G,LARIMER,2154935431,1157,151,1308,1003,76.68
2016,G,LARIMER,2154935432,1592,218,1810,1406,77.68
2016,G,LARIMER,2154935433,2051,225,2276,1816,79.79
2016,G,LARIMER,2154935434,1012,91,1103,894,81.05
2016,G,LARIMER,2155135501,1571,129,1700,1360,80
2016,G,LARIMER,2155135502,1241,97,1338,1126,84.16
2016,G,LARIMER,2155135503,1335,150,1485,1175,79.12
2016,G,LARIMER,2155135504,1417,166,1583,1234,77.95
2016,G,LARIMER,2155135505,1244,235,1479,1055,71.33
2016,G,LARIMER,2155135506,1190,129,1319,1014,76.88
2016,G,LARIMER,2155135507,1617,108,1725,1496,86.72
2016,G,LARIMER,2155135508,991,90,1081,929,85.94
2016,G,LARIMER,2155135509,860,100,960,762,79.38
2016,G,LARIMER,2155135510,1217,127,1344,1076,80.06
2016,G,LARIMER,2155135511,927,39,966,854,88.41
2016,G,LARIMER,2155135512,1480,135,1615,1321,81.8
2016,G,LARIMER,2155135513,1170,120,1290,1039,80.54
2016,G,LARIMER,2155135514,1443,175,1618,1214,75.03
2016,G,LARIMER,2155135515,1126,99,1225,971,79.27
2016,G,LARIMER,2155135516,1524,87,1611,1434,89.01
2016,G,LARIMER,2155135517,1029,81,1110,948,85.41
2016,G,LARIMER,2155135518,1604,214,1818,1360,74.81
2016,G,LARIMER,2155135519,1316,150,1466,1128,76.94
2016,G,LARIMER,2155135520,1477,179,1656,1244,75.12
2016,G,LARIMER,2155135521,1246,119,1365,1106,81.03
2016,G,LARIMER,2155135522,1582,133,1715,1468,85.6
2016,G,LARIMER,2155135523,1113,86,1199,1019,84.99
2016,G,LARIMER,2155135524,1252,184,1436,1105,76.95
2016,G,LARIMER,2155135525,636,36,672,590,87.8
2016,G,LARIMER,2155135526,1429,118,1547,1306,84.42
2016,G,LARIMER,2155135527,1342,167,1509,1172,77.67
2016,G,LARIMER,2155135528,1575,217,1792,1372,76.56
2016,G,LARIMER,2155135529,1662,309,1971,1419,71.99
2016,G,LARIMER,2155135530,1519,230,1749,1312,75.01
2016,G,LARIMER,2155135531,1292,162,1454,1174,80.74
2016,G,LARIMER,2155135532,1361,212,1573,1119,71.14
2016,G,LARIMER,2155135533,1805,368,2173,1531,70.46
2016,G,LARIMER,2155135534,1744,271,2015,1472,73.05
2016,G,LARIMER,2155135535,1590,222,1812,1354,74.72
2016,G,LARIMER,2155135536,1532,96,1628,1381,84.83
2016,G,LARIMER,2155135537,1579,94,1673,1449,86.61
2016,G,LARIMER,2155135538,1435,80,1515,1324,87.39
2016,G,LARIMER,2155135539,1421,88,1509,1277,84.63
2016,G,LARIMER,2155135540,1635,202,1837,1362,74.14
2016,G,LARIMER,2155135541,1570,131,1701,1397,82.13
2016,G,LARIMER,2155135542,1133,351,1484,979,65.97
2016,G,LARIMER,2155135543,773,84,857,668,77.95
2016,G,LARIMER,2155235601,457,76,533,340,63.79
2016,G,LARIMER,2155235602,936,52,988,861,87.15
2016,G,LARIMER,2155235603,1450,76,1526,1365,89.45
2016,G,LARIMER,2155335701,1337,138,1475,1203,81.56
2016,G,LARIMER,2155335702,1100,71,1171,1006,85.91
2016,G,LARIMER,2155335703,1081,200,1281,838,65.42
2016,G,LARIMER,2234935801,1059,94,1153,900,78.06
2016,G,LARIMER,2234935802,774,51,825,730,88.48
2016,G,LARIMER,2234935803,1287,72,1359,1197,88.08
2016,G,LARIMER,2234935804,1251,58,1309,1163,88.85
2016,G,LARIMER,2234935805,1675,106,1781,1559,87.54
2016,G,LARIMER,2234935806,894,74,968,843,87.09
2016,G,LARIMER,2234935807,1579,102,1681,1487,88.46
2016,G,LARIMER,2234935808,1071,58,1129,1008,89.28
2016,G,LARIMER,2234935809,1093,56,1149,1017,88.51
2016,G,LARIMER,2234935810,1955,173,2128,1713,80.5
2016,G,LARIMER,2235235101,897,149,1046,755,72.18
2016,G,LARIMER,2235235102,234,8,242,226,93.39
2016,G,LAS ANIMAS,4356436001,200,48,248,180,72.58
2016,G,LAS ANIMAS,4356436002,93,27,120,85,70.83
2016,G,LAS ANIMAS,4356436003,702,114,816,594,72.79
2016,G,LAS ANIMAS,4356436004,614,104,718,513,71.45
2016,G,LAS ANIMAS,4356436005,410,81,491,354,72.1
2016,G,LAS ANIMAS,4356436006,418,96,514,359,69.84
2016,G,LAS ANIMAS,4356436007,494,106,600,428,71.33
2016,G,LAS ANIMAS,4356436008,307,49,356,245,68.82
2016,G,LAS ANIMAS,4356436009,497,95,592,437,73.82
2016,G,LAS ANIMAS,4356436010,720,181,901,559,62.04
2016,G,LAS ANIMAS,4356436011,807,218,1025,600,58.54
2016,G,LAS ANIMAS,4356436012,699,210,909,555,61.06
2016,G,LAS ANIMAS,4356436013,525,116,641,413,64.43
2016,G,LAS ANIMAS,4356436014,535,87,622,437,70.26
2016,G,LAS ANIMAS,4356436015,796,143,939,641,68.26
2016,G,LAS ANIMAS,4356436016,765,163,928,620,66.81
2016,G,LINCOLN,4016437001,215,27,242,196,80.99
2016,G,LINCOLN,4016437002,380,65,445,334,75.06
2016,G,LINCOLN,4016437003,291,36,327,261,79.82
2016,G,LINCOLN,4016437004,193,22,215,176,81.86
2016,G,LINCOLN,4016437005,281,59,340,239,70.29
2016,G,LINCOLN,4016437006,256,24,280,222,79.29
2016,G,LINCOLN,4016437007,362,60,422,321,76.07
2016,G,LINCOLN,4016437008,58,7,65,54,83.08
2016,G,LINCOLN,4016437009,147,22,169,130,76.92
2016,G,LINCOLN,4016437010,168,18,186,157,84.41
2016,G,LINCOLN,4016437011,53,3,56,49,87.5
2016,G,LINCOLN,4016437012,37,3,40,32,80
2016,G,LINCOLN,4016437013,354,44,398,303,76.13
2016,G,LOGAN,4016538001,964,225,1189,831,69.89
2016,G,LOGAN,4016538002,887,236,1123,723,64.38
2016,G,LOGAN,4016538003,597,194,791,473,59.8
2016,G,LOGAN,4016538004,903,261,1164,701,60.22
2016,G,LOGAN,4016538005,717,194,911,572,62.79
2016,G,LOGAN,4016538006,709,106,815,634,77.79
2016,G,LOGAN,4016538007,1055,142,1197,962,80.37
2016,G,LOGAN,4016538008,1078,107,1185,1001,84.47
2016,G,LOGAN,4016538009,1048,100,1148,976,85.02
2016,G,LOGAN,4016538010,842,92,934,768,82.23
2016,G,LOGAN,4016538011,512,50,562,465,82.74
2016,G,LOGAN,4016538012,355,37,392,324,82.65
2016,G,LOGAN,4016538013,583,59,642,533,83.02
2016,G,LOGAN,4016538014,362,43,405,314,77.53
2016,G,LOGAN,4016538015,466,80,546,416,76.19
2016,G,LOGAN,4016538016,222,19,241,211,87.55
2016,G,MESA,3075439001,1557,297,1854,1397,75.35
2016,G,MESA,3075439002,1600,304,1904,1449,76.1
2016,G,MESA,3075439003,1461,348,1809,1346,74.41
2016,G,MESA,3075439004,1973,561,2534,1726,68.11
2016,G,MESA,3075439005,1355,281,1636,1198,73.23
2016,G,MESA,3075439006,1924,542,2466,1702,69.02
2016,G,MESA,3075439007,1545,497,2042,1362,66.7
2016,G,MESA,3075439008,786,136,922,732,79.39
2016,G,MESA,3075439009,921,117,1038,852,82.08
2016,G,MESA,3075439010,1012,162,1174,901,76.75
2016,G,MESA,3075439011,195,54,249,178,71.49
2016,G,MESA,3075439012,1268,180,1448,1132,78.18
2016,G,MESA,3075439013,1783,566,2349,1511,64.33
2016,G,MESA,3075439014,1330,234,1564,1171,74.87
2016,G,MESA,3075439015,1020,135,1155,933,80.78
2016,G,MESA,3075439016,862,166,1028,784,76.26
2016,G,MESA,3075439017,1016,262,1278,898,70.27
2016,G,MESA,3075439018,689,293,982,610,62.12
2016,G,MESA,3075439019,559,162,721,490,67.96
2016,G,MESA,3075439020,1877,436,2313,1645,71.12
2016,G,MESA,3075439021,1979,476,2455,1639,66.76
2016,G,MESA,3075439022,2129,632,2761,1819,65.88
2016,G,MESA,3075439023,1890,750,2640,1508,57.12
2016,G,MESA,3075439024,2142,1003,3145,1692,53.8
2016,G,MESA,3075439025,1915,399,2314,1692,73.12
2016,G,MESA,3075439026,2041,866,2907,1687,58.03
2016,G,MESA,3075439027,1997,366,2363,1756,74.31
2016,G,MESA,3075439028,1545,130,1675,1391,83.04
2016,G,MESA,3075439029,1678,201,1879,1526,81.21
2016,G,MESA,3075539030,2129,761,2890,1835,63.49
2016,G,MESA,3075539031,1305,222,1527,1193,78.13
2016,G,MESA,3075539032,1134,183,1317,1024,77.75
2016,G,MESA,3075539033,1714,291,2005,1589,79.25
2016,G,MESA,3075539034,942,146,1088,863,79.32
2016,G,MESA,3075539035,1419,262,1681,1328,79
2016,G,MESA,3075539036,979,129,1108,923,83.3
2016,G,MESA,3075539037,1256,304,1560,1152,73.85
2016,G,MESA,3075539038,2061,472,2533,1778,70.19
2016,G,MESA,3075539039,1880,1030,2910,1601,55.02
2016,G,MESA,3075539040,1721,557,2278,1528,67.08
2016,G,MESA,3075539041,1357,339,1696,1230,72.52
2016,G,MESA,3075539042,1589,226,1815,1475,81.27
2016,G,MESA,3075539043,2206,813,3019,1834,60.75
2016,G,MESA,3075539044,2083,846,2929,1769,60.4
2016,G,MESA,3075539045,2207,1072,3279,1827,55.72
2016,G,MESA,3075539046,2026,565,2591,1784,68.85
2016,G,MESA,3075539047,1857,295,2152,1707,79.32
2016,G,MESA,3075539048,1894,385,2279,1723,75.6
2016,G,MESA,3075539049,2076,788,2864,1734,60.54
2016,G,MESA,3075539050,1681,434,2115,1419,67.09
2016,G,MESA,3075539051,1639,362,2001,1425,71.21
2016,G,MESA,3075539052,1917,565,2482,1595,64.26
2016,G,MESA,3075539053,1950,583,2533,1612,63.64
2016,G,MESA,3075539054,2353,1064,3417,1902,55.66
2016,G,MESA,3075539055,1610,571,2181,1329,60.94
2016,G,MESA,3075539056,2161,702,2863,1835,64.09
2016,G,MESA,3075539057,2169,361,2530,1923,76.01
2016,G,MINERAL,3356240001,747,91,838,682,81.38
2016,G,MOFFAT,3085741001,1299,444,1743,1173,67.3
2016,G,MOFFAT,3085741002,614,231,845,539,63.79
2016,G,MOFFAT,3085741003,1157,247,1404,1052,74.93
2016,G,MOFFAT,3085741004,31,12,43,28,65.12
2016,G,MOFFAT,3085741005,896,317,1213,786,64.8
2016,G,MOFFAT,3085741006,227,57,284,209,73.59
2016,G,MOFFAT,3085741007,736,239,975,641,65.74
2016,G,MOFFAT,3085741008,254,104,358,212,59.22
2016,G,MOFFAT,3085741009,781,301,1082,675,62.38
2016,G,MOFFAT,3085741010,116,16,132,107,81.06
2016,G,MOFFAT,3085741011,559,296,855,496,58.01
2016,G,MOFFAT,3085741012,407,154,561,358,63.81
2016,G,MOFFAT,3085741013,392,153,545,348,63.85
2016,G,MONTEZUMA,3065842001,452,65,517,377,72.92
2016,G,MONTEZUMA,3065842002,2247,508,2755,1902,69.04
2016,G,MONTEZUMA,3065842003,1685,251,1936,1478,76.34
2016,G,MONTEZUMA,3065842004,1797,261,2058,1541,74.88
2016,G,MONTEZUMA,3065842005,986,163,1149,840,73.11
2016,G,MONTEZUMA,3065842006,679,106,785,251,31.97
2016,G,MONTEZUMA,3065842007,2070,513,2583,1592,61.63
2016,G,MONTEZUMA,3065842008,1406,427,1833,1141,62.25
2016,G,MONTEZUMA,3065842009,1397,609,2006,1052,52.44
2016,G,MONTEZUMA,3065842010,1368,281,1649,1140,69.13
2016,G,MONTEZUMA,3065842011,2258,513,2771,1875,67.67
2016,G,MONTROSE,3065843001,1055,105,1160,897,77.33
2016,G,MONTROSE,3065843002,1011,59,1070,918,85.79
2016,G,MONTROSE,3065843003,1380,194,1574,1126,71.54
2016,G,MONTROSE,3065843004,1248,195,1443,1019,70.62
2016,G,MONTROSE,3065843005,743,46,789,643,81.5
2016,G,MONTROSE,3065843006,937,92,1029,855,83.09
2016,G,MONTROSE,3065843007,763,108,871,619,71.07
2016,G,MONTROSE,3065843008,375,47,422,325,77.01
2016,G,MONTROSE,3065843009,1273,156,1429,1034,72.36
2016,G,MONTROSE,3065843010,130,8,138,121,87.68
2016,G,MONTROSE,3065843011,154,12,166,135,81.33
2016,G,MONTROSE,3065843012,1056,83,1139,906,79.54
2016,G,WELD,4016362100,1285,120,1405,1117,79.5
2016,G,MONTROSE,3065843013,1031,75,1106,883,79.84
2016,G,MONTROSE,3065843014,651,75,726,576,79.34
2016,G,MONTROSE,3065843015,22,0,22,19,86.36
2016,G,MONTROSE,3065843016,361,22,383,315,82.25
2016,G,MONTROSE,3065843017,981,99,1080,860,79.63
2016,G,MONTROSE,3065843018,1008,66,1074,912,84.92
2016,G,MONTROSE,3065843019,948,50,998,849,85.07
2016,G,MONTROSE,3065843020,1336,132,1468,1102,75.07
2016,G,MONTROSE,3065843021,1066,82,1148,956,83.28
2016,G,MONTROSE,3065843022,981,79,1060,879,82.92
2016,G,MONTROSE,3065843023,1278,159,1437,1160,80.72
2016,G,MONTROSE,3065843024,1056,106,1162,956,82.27
2016,G,MONTROSE,3065843025,1185,81,1266,1063,83.97
2016,G,MONTROSE,3065843026,950,75,1025,877,85.56
2016,G,MONTROSE,3065843027,978,104,1082,761,70.33
2016,G,MONTROSE,3065843028,1156,106,1262,977,77.42
2016,G,MORGAN,4016544001,1535,109,1644,1371,83.39
2016,G,MORGAN,4016544002,611,50,661,554,83.81
2016,G,MORGAN,4016544003,976,77,1053,752,71.42
2016,G,MORGAN,4016544004,924,92,1016,798,78.54
2016,G,MORGAN,4016544005,922,87,1009,760,75.32
2016,G,MORGAN,4016544006,1035,121,1156,804,69.55
2016,G,MORGAN,4016544007,787,88,875,575,65.71
2016,G,MORGAN,4016544008,774,104,878,583,66.4
2016,G,MORGAN,4016544009,882,105,987,704,71.33
2016,G,MORGAN,4016544010,899,94,993,743,74.82
2016,G,MORGAN,4016544011,987,50,1037,911,87.85
2016,G,MORGAN,4016544012,258,18,276,236,85.51
2016,G,MORGAN,4016544013,521,46,567,462,81.48
2016,G,MORGAN,4016544014,754,60,814,639,78.5
2016,G,MORGAN,4016544015,816,71,887,650,73.28
2016,G,MORGAN,4016544016,943,112,1055,763,72.32
2016,G,MORGAN,4016544017,1059,99,1158,952,82.21
2016,G,OTERO,4354745001,913,116,1029,789,76.68
2016,G,OTERO,4354745002,523,84,607,437,71.99
2016,G,OTERO,4354745003,829,91,920,739,80.33
2016,G,OTERO,4354745004,595,60,655,521,79.54
2016,G,OTERO,4354745005,527,109,636,381,59.91
2016,G,OTERO,4354745006,470,44,514,410,79.77
2016,G,OTERO,4354745007,494,92,586,385,65.7
2016,G,OTERO,4354745008,612,82,694,481,69.31
2016,G,OTERO,4354745009,611,94,705,514,72.91
2016,G,OTERO,4354745010,495,84,579,385,66.49
2016,G,OTERO,4354745011,686,38,724,606,83.7
2016,G,OTERO,4354745012,794,97,891,658,73.85
2016,G,OTERO,4354745013,654,129,783,480,61.3
2016,G,OTERO,4354745014,805,91,896,669,74.67
2016,G,OTERO,4354745015,496,58,554,411,74.19
2016,G,OTERO,4354745016,698,73,771,607,78.73
2016,G,OTERO,4354745017,351,80,431,291,67.52
2016,G,OURAY,3065946001,469,87,556,419,75.36
2016,G,OURAY,3065946002,686,126,812,611,75.25
2016,G,OURAY,3065946003,1189,170,1359,1104,81.24
2016,G,OURAY,3065946004,516,97,613,451,73.57
2016,G,OURAY,3065946005,918,201,1119,798,71.31
2016,G,PARK,2026047008,831,112,943,701,74.34
2016,G,PARK,2026047010,1247,199,1446,1058,73.17
2016,G,PARK,2026047011,923,125,1048,817,77.96
2016,G,PARK,2026047012,1716,247,1963,1488,75.8
2016,G,PARK,2026047013,1467,170,1637,1264,77.21
2016,G,PARK,5026047001,1538,331,1869,1290,69.02
2016,G,PARK,5026047002,763,179,942,612,64.97
2016,G,PARK,5026047003,835,138,973,732,75.23
2016,G,PARK,5026047004,273,39,312,231,74.04
2016,G,PARK,5026047005,585,74,659,521,79.06
2016,G,PARK,5026047006,770,92,862,674,78.19
2016,G,PARK,5026047007,832,124,956,709,74.16
2016,G,PARK,5026047009,636,93,729,545,74.76
2016,G,PHILLIPS,4016548001,454,81,535,399,74.58
2016,G,PHILLIPS,4016548002,115,21,136,103,75.74
2016,G,PHILLIPS,4016548003,328,87,415,278,66.99
2016,G,PHILLIPS,4016548004,556,109,665,486,73.08
2016,G,PHILLIPS,4016548005,197,19,216,181,83.8
2016,G,PHILLIPS,4016548006,383,54,437,338,77.35
2016,G,PHILLIPS,4016548007,469,87,556,408,73.38
2016,G,PHILLIPS,4016548008,232,76,308,201,65.26
2016,G,PITKIN,3056149001,1348,226,1574,1146,72.81
2016,G,PITKIN,3056149002,1269,361,1630,1025,62.88
2016,G,PITKIN,3056149003,1137,235,1372,982,71.57
2016,G,PITKIN,3056149004,1183,230,1413,979,69.29
2016,G,PITKIN,3056149005,1122,239,1361,964,70.83
2016,G,PITKIN,3056149006,1921,385,2306,1595,69.17
2016,G,PITKIN,3056149007,2014,360,2374,1730,72.87
2016,G,PITKIN,3056149008,816,142,958,680,70.98
2016,G,PITKIN,3056149009,1186,260,1446,1030,71.23
2016,G,PITKIN,3056149010,737,110,847,645,76.15
2016,G,PROWERS,4356450001,405,100,505,307,60.79
2016,G,PROWERS,4356450002,407,41,448,300,66.96
2016,G,PROWERS,4356450003,400,39,439,310,70.62
2016,G,PROWERS,4356450004,401,62,463,327,70.63
2016,G,PROWERS,4356450005,532,105,637,369,57.93
2016,G,PROWERS,4356450006,434,35,469,389,82.94
2016,G,PROWERS,4356450007,511,53,564,445,78.9
2016,G,PROWERS,4356450008,623,119,742,520,70.08
2016,G,PROWERS,4356450009,347,88,435,283,65.06
2016,G,PROWERS,4356450010,776,131,907,688,75.85
2016,G,PROWERS,4356450011,539,84,623,422,67.74
2016,G,PROWERS,4356450012,490,72,562,422,75.09
2016,G,PROWERS,4356450013,422,30,452,352,77.88
2016,G,PUEBLO,3034651020,180,30,210,141,67.14
2016,G,PUEBLO,3034651021,769,179,948,532,56.12
2016,G,PUEBLO,3034651036,664,69,733,567,77.35
2016,G,PUEBLO,3034651037,594,59,653,521,79.79
2016,G,PUEBLO,3034651038,768,137,905,610,67.4
2016,G,PUEBLO,3034651039,366,91,457,283,61.93
2016,G,PUEBLO,3034651040,412,56,468,358,76.5
2016,G,PUEBLO,3034651041,446,92,538,359,66.73
2016,G,PUEBLO,3034651042,546,222,768,370,48.18
2016,G,PUEBLO,3034651043,456,117,573,336,58.64
2016,G,PUEBLO,3034651044,436,113,549,333,60.66
2016,G,PUEBLO,3034651048,527,138,665,366,55.04
2016,G,PUEBLO,3034651049,417,71,488,326,66.8
2016,G,PUEBLO,3034651050,846,197,1043,577,55.32
2016,G,PUEBLO,3034651051,930,205,1135,717,63.17
2016,G,PUEBLO,3034651052,714,118,832,566,68.03
2016,G,PUEBLO,3034651053,589,56,645,462,71.63
2016,G,PUEBLO,3034651054,475,86,561,365,65.06
2016,G,PUEBLO,3034651055,590,41,631,516,81.77
2016,G,PUEBLO,3034651056,522,40,562,459,81.67
2016,G,PUEBLO,3034651057,780,62,842,656,77.91
2016,G,PUEBLO,3034651058,670,40,710,606,85.35
2016,G,PUEBLO,3034651059,470,70,540,347,64.26
2016,G,PUEBLO,3034651060,870,82,952,734,77.1
2016,G,PUEBLO,3034651061,706,78,784,597,76.15
2016,G,PUEBLO,3034651062,745,83,828,655,79.11
2016,G,PUEBLO,3034651063,1108,115,1223,933,76.29
2016,G,PUEBLO,3034651064,215,36,251,149,59.36
2016,G,PUEBLO,3034651065,94,2,96,88,91.67
2016,G,PUEBLO,3034651066,956,63,1019,844,82.83
2016,G,PUEBLO,3034651067,625,103,728,499,68.54
2016,G,PUEBLO,3034651068,505,65,570,406,71.23
2016,G,PUEBLO,3034651069,833,97,930,648,69.68
2016,G,PUEBLO,3034651070,557,148,705,385,54.61
2016,G,PUEBLO,3034651071,688,129,817,518,63.4
2016,G,PUEBLO,3034651072,715,118,833,545,65.43
2016,G,PUEBLO,3034651073,627,135,762,418,54.86
2016,G,PUEBLO,3034651074,679,133,812,489,60.22
2016,G,PUEBLO,3034651075,811,155,966,611,63.25
2016,G,PUEBLO,3034651076,434,63,497,316,63.58
2016,G,PUEBLO,3034651077,456,142,598,322,53.85
2016,G,PUEBLO,3034651078,503,105,608,356,58.55
2016,G,PUEBLO,3034651079,679,130,809,472,58.34
2016,G,PUEBLO,3034651080,878,118,996,714,71.69
2016,G,PUEBLO,3034651081,735,116,851,574,67.45
2016,G,PUEBLO,3034651082,1313,146,1459,1090,74.71
2016,G,PUEBLO,3034651083,761,86,847,602,71.07
2016,G,PUEBLO,3034651084,865,89,954,712,74.63
2016,G,PUEBLO,3034651085,715,88,803,590,73.47
2016,G,PUEBLO,3034651086,994,135,1129,825,73.07
2016,G,PUEBLO,3034651087,857,62,919,760,82.7
2016,G,PUEBLO,3034651088,1392,109,1501,1248,83.14
2016,G,PUEBLO,3034651209,985,93,1078,875,81.17
2016,G,PUEBLO,3034651210,520,74,594,421,70.88
2016,G,PUEBLO,3034651211,980,166,1146,808,70.51
2016,G,PUEBLO,3034651212,826,188,1014,666,65.68
2016,G,PUEBLO,3034651213,1294,118,1412,1171,82.93
2016,G,PUEBLO,3034651214,1528,226,1754,1295,73.83
2016,G,PUEBLO,3034651215,1167,117,1284,1026,79.91
2016,G,PUEBLO,3034651216,834,91,925,712,76.97
2016,G,PUEBLO,3034651217,616,83,699,545,77.97
2016,G,PUEBLO,3034651218,1197,124,1321,1068,80.85
2016,G,PUEBLO,3034651219,1103,115,1218,973,79.89
2016,G,PUEBLO,3034651220,988,113,1101,884,80.29
2016,G,PUEBLO,3034751001,1302,260,1562,1080,69.14
2016,G,PUEBLO,3034751002,1544,228,1772,1261,71.16
2016,G,PUEBLO,3034751003,1381,209,1590,1150,72.33
2016,G,PUEBLO,3034751004,1164,119,1283,1043,81.29
2016,G,PUEBLO,3034751005,597,68,665,536,80.6
2016,G,PUEBLO,3034751006,653,248,901,490,54.38
2016,G,PUEBLO,3034751007,1017,114,1131,861,76.13
2016,G,PUEBLO,3034751008,1091,96,1187,931,78.43
2016,G,PUEBLO,3034751009,697,82,779,575,73.81
2016,G,PUEBLO,3034751010,1236,340,1576,894,56.73
2016,G,PUEBLO,3034751011,954,95,1049,798,76.07
2016,G,PUEBLO,3034751015,916,151,1067,716,67.1
2016,G,PUEBLO,3034751016,897,170,1067,688,64.48
2016,G,PUEBLO,3034751017,1001,105,1106,830,75.05
2016,G,PUEBLO,3034751018,1486,293,1779,1179,66.27
2016,G,PUEBLO,3034751019,305,53,358,237,66.2
2016,G,PUEBLO,3034751022,546,101,647,394,60.9
2016,G,PUEBLO,3034751023,958,181,1139,747,65.58
2016,G,PUEBLO,3034751024,876,137,1013,734,72.46
2016,G,PUEBLO,3034751033,220,62,282,155,54.96
2016,G,PUEBLO,3034751034,663,241,904,442,48.89
2016,G,PUEBLO,3034751035,221,72,293,152,51.88
2016,G,PUEBLO,3034751113,680,155,835,524,62.75
2016,G,PUEBLO,3034751201,1267,190,1457,1112,76.32
2016,G,PUEBLO,3034751202,1026,150,1176,887,75.43
2016,G,PUEBLO,3034751203,1177,200,1377,970,70.44
2016,G,PUEBLO,3034751204,741,106,847,613,72.37
2016,G,PUEBLO,3034751205,692,121,813,569,69.99
2016,G,PUEBLO,3034751206,981,204,1185,817,68.95
2016,G,PUEBLO,3034751207,1019,173,1192,885,74.24
2016,G,PUEBLO,3034751208,1229,184,1413,988,69.92
2016,G,PUEBLO,3036251012,1088,168,1256,863,68.71
2016,G,PUEBLO,3036251013,1002,236,1238,741,59.85
2016,G,PUEBLO,3036251014,750,173,923,513,55.58
2016,G,PUEBLO,3036251025,710,206,916,481,52.51
2016,G,PUEBLO,3036251026,784,140,924,596,64.5
2016,G,PUEBLO,3036251027,776,138,914,554,60.61
2016,G,PUEBLO,3036251028,674,207,881,444,50.4
2016,G,PUEBLO,3036251029,514,140,654,344,52.6
2016,G,PUEBLO,3036251030,852,147,999,595,59.56
2016,G,PUEBLO,3036251031,898,211,1109,615,55.46
2016,G,PUEBLO,3036251032,553,160,713,350,49.09
2016,G,PUEBLO,3036251045,179,43,222,125,56.31
2016,G,PUEBLO,3036251046,707,129,836,473,56.58
2016,G,PUEBLO,3036251047,557,98,655,382,58.32
2016,G,PUEBLO,3036251101,385,35,420,291,69.29
2016,G,PUEBLO,3036251102,651,61,712,545,76.54
2016,G,PUEBLO,3036251104,891,81,972,766,78.81
2016,G,PUEBLO,3354651301,1519,249,1768,1320,74.66
2016,G,PUEBLO,3354651302,878,95,973,794,81.6
2016,G,PUEBLO,3354651303,416,50,466,373,80.04
2016,G,PUEBLO,3354651401,761,63,824,688,83.5
2016,G,PUEBLO,3354651402,841,67,908,736,81.06
2016,G,PUEBLO,3354651403,763,69,832,677,81.37
2016,G,PUEBLO,3354751106,969,71,1040,851,81.83
2016,G,PUEBLO,3354751107,1362,114,1476,1180,79.95
2016,G,PUEBLO,3354751108,721,52,773,618,79.95
2016,G,PUEBLO,3354751109,684,79,763,554,72.61
2016,G,PUEBLO,3354751110,222,17,239,193,80.75
2016,G,PUEBLO,3354751111,560,86,646,447,69.2
2016,G,PUEBLO,3354751112,413,53,466,338,72.53
2016,G,PUEBLO,3356251103,773,57,830,661,79.64
2016,G,PUEBLO,3356251105,1248,80,1328,1116,84.04
2016,G,PUEBLO,3356251304,439,37,476,395,82.98
2016,G,RIO BLANCO,3085752001,857,178,1035,755,72.95
2016,G,RIO BLANCO,3085752002,734,148,882,637,72.22
2016,G,RIO BLANCO,3085752003,1075,192,1267,945,74.59
2016,G,RIO BLANCO,3085752004,1241,157,1398,1113,79.61
2016,G,RIO BLANCO,3085752005,62,6,68,56,82.35
2016,G,RIO GRANDE,3356253001,295,70,365,248,67.95
2016,G,RIO GRANDE,3356253002,505,90,595,418,70.25
2016,G,RIO GRANDE,3356253003,714,121,835,605,72.46
2016,G,RIO GRANDE,3356253004,338,63,401,259,64.59
2016,G,RIO GRANDE,3356253005,432,52,484,381,78.72
2016,G,RIO GRANDE,3356253006,159,16,175,141,80.57
2016,G,RIO GRANDE,3356253007,472,71,543,424,78.08
2016,G,RIO GRANDE,3356253008,621,92,713,526,73.77
2016,G,RIO GRANDE,3356253009,445,63,508,337,66.34
2016,G,RIO GRANDE,3356253010,836,223,1059,722,68.18
2016,G,RIO GRANDE,3356253011,486,86,572,423,73.95
2016,G,RIO GRANDE,3356253012,364,75,439,294,66.97
2016,G,RIO GRANDE,3356253013,348,55,403,300,74.44
2016,G,RIO GRANDE,3356253014,461,87,548,384,70.07
2016,G,RIO GRANDE,3356253015,391,68,459,285,62.09
2016,G,ROUTT,3082654001,814,117,931,704,75.62
2016,G,ROUTT,3082654002,582,79,661,512,77.46
2016,G,ROUTT,3082654003,992,115,1107,900,81.3
2016,G,ROUTT,3082654004,588,74,662,530,80.06
2016,G,ROUTT,3082654005,1124,192,1316,970,73.71
2016,G,ROUTT,3082654006,1081,125,1206,967,80.18
2016,G,ROUTT,3082654007,518,81,599,440,73.46
2016,G,ROUTT,3082654008,844,164,1008,732,72.62
2016,G,ROUTT,3082654009,744,173,917,643,70.12
2016,G,ROUTT,3082654010,481,63,544,414,76.1
2016,G,ROUTT,3082654011,1164,323,1487,921,61.94
2016,G,ROUTT,3082654012,728,132,860,636,73.95
2016,G,ROUTT,3082654013,1115,233,1348,973,72.18
2016,G,ROUTT,3082654014,872,156,1028,761,74.03
2016,G,ROUTT,3082654015,1375,236,1611,1198,74.36
2016,G,ROUTT,3082654016,1280,256,1536,1115,72.59
2016,G,ROUTT,3082654017,1144,385,1529,922,60.3
2016,G,ROUTT,3082654018,1275,363,1638,1080,65.93
2016,G,SAGUACHE,3356255001,996,222,1218,860,70.61
2016,G,SAGUACHE,3356255002,106,17,123,96,78.05
2016,G,SAGUACHE,3356255003,233,82,315,182,57.78
2016,G,SAGUACHE,3356255004,241,46,287,190,66.2
2016,G,SAGUACHE,3356255005,845,163,1008,682,67.66
2016,G,SAGUACHE,3356255006,648,119,767,474,61.8
2016,G,SAGUACHE,3356255007,631,127,758,456,60.16
2016,G,SAN JUAN,3065956001,603,131,734,520,70.84
2016,G,SAN MIGUEL,3065857001,1871,404,2275,1532,67.34
2016,G,SAN MIGUEL,3065857002,1200,182,1382,1036,74.96
2016,G,SAN MIGUEL,3065857003,622,82,704,540,76.7
2016,G,SAN MIGUEL,3065857004,902,137,1039,771,74.21
2016,G,SAN MIGUEL,3065857005,96,15,111,81,72.97
2016,G,SAN MIGUEL,3065857006,612,206,818,502,61.37
2016,G,SEDGWICK,4016558001,386,62,448,349,77.9
2016,G,SEDGWICK,4016558002,303,42,345,280,81.16
2016,G,SEDGWICK,4016558003,345,34,379,295,77.84
2016,G,SEDGWICK,4016558004,246,37,283,215,75.97
2016,G,SEDGWICK,4016558005,294,55,349,261,74.79
2016,G,SUMMIT,2086159001,1393,574,1967,1077,54.75
2016,G,SUMMIT,2086159002,1362,465,1827,1078,59
2016,G,SUMMIT,2086159003,769,245,1014,626,61.74
2016,G,SUMMIT,2086159004,1480,426,1906,1217,63.85
2016,G,SUMMIT,2086159005,1447,353,1800,1207,67.06
2016,G,SUMMIT,2086159006,767,186,953,624,65.48
2016,G,SUMMIT,2086159007,955,405,1360,696,51.18
2016,G,SUMMIT,2086159008,605,226,831,477,57.4
2016,G,SUMMIT,2086159009,1338,449,1787,1036,57.97
2016,G,SUMMIT,2086159010,914,144,1058,794,75.05
2016,G,SUMMIT,2086159011,643,163,806,564,69.98
2016,G,SUMMIT,2086159012,330,55,385,273,70.91
2016,G,SUMMIT,2086159013,1068,184,1252,919,73.4
2016,G,SUMMIT,2086159014,779,308,1087,623,57.31
2016,G,SUMMIT,2086159015,926,262,1188,795,66.92
2016,G,SUMMIT,2086159016,931,290,1221,737,60.36
2016,G,SUMMIT,2086159017,1235,357,1592,1028,64.57
2016,G,SUMMIT,2086159018,1279,579,1858,1015,54.63
2016,G,SUMMIT,2086159019,1180,333,1513,981,64.84
2016,G,SUMMIT,2086159020,1077,353,1430,878,61.4
2016,G,TELLER,5023960001,1519,238,1757,1306,74.33
2016,G,TELLER,5023960002,1329,215,1544,1160,75.13
2016,G,TELLER,5023960003,1632,240,1872,1400,74.79
2016,G,TELLER,5023960004,1528,191,1719,1314,76.44
2016,G,TELLER,5023960005,830,96,926,731,78.94
2016,G,TELLER,5023960006,410,75,485,349,71.96
2016,G,TELLER,5023960007,1746,216,1962,1491,75.99
2016,G,TELLER,5023960008,1482,172,1654,1294,78.23
2016,G,TELLER,5023960009,1505,205,1710,1332,77.89
2016,G,TELLER,5023960010,1283,174,1457,1113,76.39
2016,G,TELLER,5023960011,1823,298,2121,1502,70.82
2016,G,TELLER,5023960012,1198,164,1362,1027,75.4
2016,G,TELLER,5023960013,883,161,1044,717,68.68
2016,G,WASHINGTON,4016461001,125,7,132,115,87.12
2016,G,WASHINGTON,4016461002,1574,172,1746,1432,82.02
2016,G,WASHINGTON,4016461003,167,9,176,154,87.5
2016,G,WASHINGTON,4016461004,585,54,639,512,80.13
2016,G,WASHINGTON,4016461005,222,24,246,202,82.11
2016,G,WASHINGTON,4016461006,390,31,421,369,87.65
2016,G,WELD,4014862118,1304,72,1376,1149,83.5
2016,G,WELD,4014862119,727,60,787,622,79.03
2016,G,WELD,4014862126,1493,125,1618,1270,78.49
2016,G,WELD,4014862127,1128,116,1244,949,76.29
2016,G,WELD,4014862128,1677,97,1774,1487,83.82
2016,G,WELD,4014862134,1279,102,1381,1111,80.45
2016,G,WELD,4014862316,841,46,887,730,82.3
2016,G,WELD,4016362101,386,38,424,352,83.02
2016,G,WELD,4016362102,289,17,306,250,81.7
2016,G,WELD,4016362103,441,28,469,399,85.07
2016,G,WELD,4016362104,1839,131,1970,1614,81.93
2016,G,WELD,4016362308,836,38,874,735,84.1
2016,G,WELD,4016362310,1866,146,2012,1562,77.63
2016,G,WELD,4016362311,1970,180,2150,1725,80.23
2016,G,WELD,4016362312,478,39,517,432,83.56
2016,G,WELD,4016362314,1292,119,1411,1030,73
2016,G,WELD,4016362320,1146,118,1264,943,74.6
2016,G,WELD,4016362327,1608,230,1838,1305,71
2016,G,WELD,4134862120,569,33,602,507,84.22
2016,G,WELD,4134862124,1795,136,1931,1587,82.19
2016,G,WELD,4134862125,1733,128,1861,1578,84.79
2016,G,WELD,4134862135,1087,73,1160,993,85.6
2016,G,WELD,4134862136,1233,94,1327,1077,81.16
2016,G,WELD,4134862146,532,75,607,386,63.59
2016,G,WELD,4134862212,1387,188,1575,1241,78.79
2016,G,WELD,4134862213,2432,192,2624,2075,79.08
2016,G,WELD,4134862214,1381,76,1457,1265,86.82
2016,G,WELD,4134862215,1212,74,1286,1088,84.6
2016,G,WELD,4134862217,1660,180,1840,1388,75.43
2016,G,WELD,4134862221,1872,318,2190,1525,69.63
2016,G,WELD,4134862222,1390,108,1498,1261,84.18
2016,G,WELD,4134862223,1287,105,1392,1167,83.84
2016,G,WELD,4134862224,756,59,815,653,80.12
2016,G,WELD,4134862225,1178,98,1276,1028,80.56
2016,G,WELD,4134862226,1735,205,1940,1448,74.64
2016,G,WELD,4134862228,1561,177,1738,1288,74.11
2016,G,WELD,4134862235,1705,99,1804,1519,84.2
2016,G,WELD,4134862238,1273,168,1441,1088,75.5
2016,G,WELD,4134862241,831,84,915,704,76.94
2016,G,WELD,4134862243,1234,105,1339,1067,79.69
2016,G,WELD,4134862246,1513,160,1673,1251,74.78
2016,G,WELD,4134862309,1904,163,2067,1578,76.34
2016,G,WELD,4134862326,1152,118,1270,944,74.33
2016,G,WELD,4134862331,1337,108,1445,1140,78.89
2016,G,WELD,4134862333,749,87,836,587,70.22
2016,G,WELD,4134862338,111,4,115,96,83.48
2016,G,WELD,4134962145,16,2,18,16,88.89
2016,G,WELD,4135062105,1407,253,1660,966,58.19
2016,G,WELD,4135062106,1400,174,1574,972,61.75
2016,G,WELD,4135062107,1368,331,1699,924,54.38
2016,G,WELD,4135062108,1496,261,1757,1129,64.26
2016,G,WELD,4135062109,1588,304,1892,1242,65.64
2016,G,WELD,4135062110,1590,444,2034,1121,55.11
2016,G,WELD,4135062111,1450,222,1672,1120,66.99
2016,G,WELD,4135062112,1282,354,1636,982,60.02
2016,G,WELD,4135062113,1327,467,1794,1044,58.19
2016,G,WELD,4135062114,1046,111,1157,923,79.78
2016,G,WELD,4135062132,1071,83,1154,919,79.64
2016,G,WELD,4135062137,1256,355,1611,910,56.49
2016,G,WELD,4135062141,1059,154,1213,749,61.75
2016,G,WELD,4135062211,1375,159,1534,1071,69.82
2016,G,WELD,4135062220,1829,250,2079,1487,71.52
2016,G,WELD,4135062236,1622,132,1754,1316,75.03
2016,G,WELD,4135062249,1022,144,1166,855,73.33
2016,G,WELD,4135062317,1641,491,2132,1387,65.06
2016,G,WELD,4135062318,945,134,1079,787,72.94
2016,G,WELD,4135062319,1281,284,1565,975,62.3
2016,G,WELD,4135062321,1431,355,1786,976,54.65
2016,G,WELD,4135062322,1542,216,1758,1155,65.7
2016,G,WELD,4135062323,1508,148,1656,1147,69.26
2016,G,WELD,4135062324,1343,206,1549,1046,67.53
2016,G,WELD,4135062325,1296,269,1565,920,58.79
2016,G,WELD,4135062329,1369,213,1582,1077,68.08
2016,G,WELD,4135062330,1963,219,2182,1588,72.78
2016,G,WELD,4136362202,434,26,460,372,80.87
2016,G,WELD,4136362300,1293,98,1391,1035,74.41
2016,G,WELD,4136362301,1414,139,1553,1108,71.35
2016,G,WELD,4136362302,1434,181,1615,1136,70.34
2016,G,WELD,4136362303,906,71,977,759,77.69
2016,G,WELD,4136362304,1358,108,1466,1157,78.92
2016,G,WELD,4136362313,626,38,664,536,80.72
2016,G,WELD,4234862117,1046,67,1113,965,86.7
2016,G,WELD,4234862131,877,54,931,789,84.75
2016,G,WELD,4234862138,1838,154,1992,1640,82.33
2016,G,WELD,4234862227,1096,96,1192,961,80.62
2016,G,WELD,4234862230,1677,129,1806,1489,82.45
2016,G,WELD,4234862232,1835,176,2011,1559,77.52
2016,G,WELD,4234862244,1503,147,1650,1310,79.39
2016,G,WELD,4234862245,1606,155,1761,1408,79.95
2016,G,WELD,4234962115,1703,172,1875,1536,81.92
2016,G,WELD,4234962116,1036,126,1162,889,76.51
2016,G,WELD,4234962121,493,45,538,452,84.01
2016,G,WELD,4234962122,1579,166,1745,1339,76.73
2016,G,WELD,4234962123,1462,144,1606,1233,76.77
2016,G,WELD,4234962129,136,7,143,125,87.41
2016,G,WELD,4234962130,1355,65,1420,1259,88.66
2016,G,WELD,4234962133,1138,70,1208,1016,84.11
2016,G,WELD,4234962139,1474,111,1585,1312,82.78
2016,G,WELD,4234962140,1425,132,1557,1270,81.57
2016,G,WELD,4234962143,865,36,901,783,86.9
2016,G,WELD,4234962229,1073,69,1142,969,84.85
2016,G,WELD,4234962231,347,19,366,323,88.25
2016,G,WELD,4236362200,1413,99,1512,1259,83.27
2016,G,WELD,4236362203,826,102,928,715,77.05
2016,G,WELD,4236362204,1818,128,1946,1616,83.04
2016,G,WELD,4236362205,1973,202,2175,1610,74.02
2016,G,WELD,4236362206,947,96,1043,808,77.47
2016,G,WELD,4236362207,1536,148,1684,1345,79.87
2016,G,WELD,4236362208,937,57,994,845,85.01
2016,G,WELD,4236362209,1390,169,1559,1151,73.83
2016,G,WELD,4236362210,939,85,1024,836,81.64
2016,G,WELD,4236362218,1297,115,1412,1123,79.53
2016,G,WELD,4236362219,960,71,1031,860,83.41
2016,G,WELD,4236362233,1225,156,1381,1015,73.5
2016,G,WELD,4236362237,1099,66,1165,981,84.21
2016,G,WELD,4236362239,1725,181,1906,1503,78.86
2016,G,WELD,4236362240,1489,109,1598,1334,83.48
2016,G,WELD,4236362242,1481,164,1645,1242,75.5
2016,G,WELD,4236362305,861,55,916,779,85.04
2016,G,WELD,4236362306,1220,129,1349,1031,76.43
2016,G,WELD,4236362307,2521,184,2705,2298,84.95
2016,G,WELD,4236362315,2,2,4,0,0
2016,G,WELD,4236362328,304,14,318,274,86.16
2016,G,WELD,4236362332,1823,216,2039,1637,80.28
2016,G,WELD,4236362334,1624,192,1816,1436,79.07
2016,G,WELD,4236362335,1223,83,1306,1119,85.68
2016,G,WELD,4236362336,755,72,827,689,83.31
2016,G,WELD,4236362337,1262,151,1413,1052,74.45
2016,G,WELD,4236362339,1067,88,1155,969,83.9
2016,G,WELD,4236362340,1495,153,1648,1186,71.97
2016,G,YUMA,4016563001,437,56,493,378,76.67
2016,G,YUMA,4016563002,472,74,546,402,73.63
2016,G,YUMA,4016563003,220,38,258,188,72.87
2016,G,YUMA,4016563004,710,93,803,630,78.46
2016,G,YUMA,4016563005,184,15,199,161,80.9
2016,G,YUMA,4016563006,560,57,617,503,81.52
2016,G,YUMA,4016563007,136,6,142,124,87.32
2016,G,YUMA,4016563008,187,11,198,174,87.88
2016,G,YUMA,4016563009,334,20,354,296,83.62
2016,G,YUMA,4016563010,338,21,359,305,84.96
2016,G,YUMA,4016563011,462,50,512,394,76.95
2016,G,YUMA,4016563012,523,59,582,458,78.69
2016,G,YUMA,4016563013,537,68,605,453,74.88
2016,G,YUMA,4016563014,502,45,547,423,77.33
